您好，我想咨询一下小米的空气净化器|您好，有什么可以帮到您的吗|我想了解一下空气净化器|您好，我想询问一下空气净化器的信息|我想问一下空气净化器|我有关于空气净化器的问题想问一下|您好，可以给我介绍一下小米的空气净化器吗
小米空气净化器2多少钱|您好，小米空气净化器2现在售价599元|最新的空气净化器多少钱|小米最新的空气净化器多少钱|最新款的空气净化器多贵|我想了解一下最新的空气净化器的价位|现在最新的空气净化器价位是怎样的
小米空气净化器2效果如何|您好，小米空气净化器2颗粒物CADR高达310m^3/h|新的空气净化器性能如何|小米空气净化器2的净化效果如何|小米空气净化器2的净化性能如何|新的空气净化器能力怎样|新的空气净化器能达到怎样的效果
小米空气净化器2占地大吗|您好，小米空气净化器2体积比第一代减小了40%|新的空气净化器大小有多大|新的空气净化器体积有多大|小米空气净化器2体积上怎样|小米空气净化器2有多大|新的空气净化器不会很占地吧
小米空气净化器2的净化原理是怎样的|您好，小米空气净化器2运用了全新的空气增压系统|小米空气净化器2运用了怎样的技术|新的空气净化器靠什么净化空气|新的空气净化器用了什么黑科技|小米空气净化器在空气净化技术上有什么提升|新的空气净化器技术上有什么提升
小米空气净化器2能放在家中的哪些地方|您好，小米空气净化器2能防止在各个房间，都有良好的效果|新的空气净化器能放在哪|我能在哪些房间放置小米空气净化器2|哪些位置适合放空气净化器2|这个空气净化器能放在哪些位置|这个空气净化器在家里的哪里放置
小米空气净化器2能用手机控制吗|您好，小米空气净化器2能通过小米智能家庭APP控制|这个空气净化器能远程操控吗|我能用手机控制这个空气净化器吗|能给我介绍一下智能控制吗|小米空气净化器2能用手机操控吗|有什么APP能远程控制吗
小米空气净化器2的耗电怎么样|您好，小米空气净化器2的功耗只有4.8W|小米空气净化器耗电如何|这个空气净化器能耗如何|这个空气净化器省电吗|这个空气净化器功率多大|新的空气净化器功率如何
小米空气净化器2的声音大吗|您好，小米空气净化器2的睡眠模式可以静音工作|这个空气净化器吵吗|这个空气净化器会过于吵导致难以入睡吗|新的空气净化器声音大吗|新的空气净化器噪音大吗|这个空气净化器噪音大吗
小米空气净化器2有售后吗|您好，我们有520家线下售后网点|这个空气净化器支持售后服务吗|这个空气净化器有售后服务吗|如果我要找售后怎么办|我能在哪里找到售后|小米的售后怎么样
请问除甲醛效果怎么样？|您好，效果一般，除甲醛还得使用专业机器|能去除甲醛吗|对甲醛的去除效果好吗|新的空气净化器能除甲醛吗|这东西能去除甲醛吗|我能用这产品去除甲醛吗
请问除烟味效果怎样|您好，效果不错，可以使用|这个能除烟味吗|能去除烟味吗|新的空气净化器能除烟味吗|这东西能去除烟味吗|我能用这产品去除烟味吗
新的空气净化器什么时候会有活动|您好，您可以关注各大商城|新的空气净化器会降价吗|空气净化器会降价吗|这个产品近期会有活动吗|这个产品会有什么折扣吗|这个产品近期会降价吗
刚买的滤芯用不用拆开|您好，不用的，插电就可以使用|新的空气净化器在用前要注意什么|新的空气净化器的滤芯要处理吗|机器的滤芯用前要清洗吗|这个滤芯要处理后才能用吗|买来产品后，对滤芯要清洗处理吗
滤芯一般多久更换一次|您好，大约使用半年后更换一次|空气净化器的滤芯可以用多久|这个产品的滤芯寿命多长|滤芯更换周期多久|空气净化器的滤芯多久更换一次哦|空气净化器的滤芯要更换吗
使用空气净化器需要开窗吗|您好，使用时无需开窗|需要开窗通风吗|需要流动空气吗|使用时一定要开窗吗|使用时要开窗通风吗|空气净化器使用时要开窗嘛
能去除宠物的臭味吗|您好，可以的，请放心使用|空气净化器能去除宠物味道吗|宠物的异味可以去除吗|空气净化器能去除宠物带来的异味吗|这件产品能去除宠物异味吗|它能除宠物臭味吗
滤芯可以用水洗吗|您好，这是不可以的，会破坏滤芯|滤芯清洗是用水洗吗|我能用水清洗滤芯吗|滤芯需要用水洗吗|滤芯能用水洗吗|滤芯要定时清洗吗
净化范围有多大|您好，最佳的净化范围在25-30平方米之间|范围多大呀|多大的房间适合放呢|净化面积有多大|多大的房间适合放空气净化器|这个产品适合多大的房间
这个产品可以调节室内湿度吗|您好，不行的，调节湿度还得用加湿器|它能调节湿度吗|我能用空气净化器调节湿度吗|这件产品能调节湿度吗|我能用它调节房间湿度吗|房间湿度也可以调节吗
使用时应该怎样放置|您好，请立式放置空气净化器|它应该怎样摆放|他需要摆成怎样的角度|它应该立着放还是横着放|我需要怎样摆放它|放置时有什么要注意的吗
有遥控器吗|您好，目前没有遥控器，您可以使用手机APP操控|有配备遥控器吗|会赠送遥控器吗|有附赠的遥控器吗|它能用遥控器操控吗|它支持遥控器操控吗
如何判断空气质量|您好，可以通过面板上的数字大小来判断，值小说明空气好|我怎么了解到空气质量|如何看到空气质量好坏|如何判断空气质量好坏|怎么看出效果|如何读出空气质量
有负离子功能吗|您好，负离子功能是没有的|空气净化器支持负离子功能吗|它支持负离子功能吗|它能提供负离子吗|它能产生负离子吗|它能制造负离子吗
购买的时候要额外买滤芯吗|您好，购买时本身带有一个滤芯|滤芯需要额外购买吗|会赠送滤芯吗|滤芯会随商品一起吗|滤芯要单独购买吗|我需要单独再买一个滤芯吗
能吸入宠物毛发吗|您好，这个的净化难度较高|能去除宠物毛发吗|能用来清洁空气中的毛发吗|对毛发有效果吗|能用来吸收宠物毛发吗|它能够清理宠物毛发吗
小米空气净化器2有货吗|您好，您可以在在线商城查看相关信息|空气净化器2现在有货吗|我如何知道空气净化器2现在是否有货|空气净化器2现在有库存吗|能告诉我一下空气净化器2现在有货吗|我想了解一下空气净化器2现在是否有货
空气净化器2能退货吗|您好，这件商品支持7天无理由退货|空气净化器2的退货服务怎样|若是对空气净化器2不满意，能退货吗|空气净化器2的退货政策是怎样的|我能退货空气净化器2吗|空气净化器2的退货保障是怎样的
空气净化器2能更换吗|您好，这件商品支持15天免费换货|空气净化器2的换货服务是怎样的|若是对空气净化器2不满意，能更换吗|空气净化器2能更换吗|我能更换不满意的空气净化器2吗|空气净化器2的换货政策是怎样的
空气净化器2包邮吗|您好，购物满150元就可包邮|空气净化器2邮费可以免吗|购物满多少钱包邮费呢|如何才能包邮呢|这件产品包邮吗|空气净化器2邮费要额外算吗
您好，我想了解一下空气净化器pro|您好，有什么可以帮到您的吗|能介绍一下空气净化器pro|我想了解一下空气净化器pro|我想咨询一下空气净化器pro|我想问一些关于空气净化器pro的问题|我想询问一下空气净化器pro的信息
小米空气净化器pro多少钱|您好，空气净化器pro现在售价1199元|空气净化器pro的价位如何|我想了解一下空气净化器pro的价位|能告诉我一下空气净化器pro的价格吗|空气净化器pro要多少钱|现在空气净化器pro售价如何
小米空气净化器pro净化效果如何|您好，小米空气净化器pro颗粒物CADR高达500m^3/h|小米空气净化器pro净化性能如何|小米空气净化器pro净化效果如何|我想了解一下小米空气净化器pro的性能|能给我介绍一下空气净化器pro的净化效果吗|方便给我介绍一下空气净化器pro的净化能力吗
空气净化器pro适用面积有多大|您好，小米空气净化器pro适用于35-60平方米的房间|空气净化器pro的净化范围有多大|空气净化器pro适用于多大的房间|空气净化器pro在多大的范围内有良好的效果|空气净化器pro能净化多大范围|小米空气净化器pro净化面积有多大
可以去除甲醛吗|您好，小米空气净化器pro功能强劲，可以的|这个能去除甲醛吗|小米空气净化器pro能用来去除甲醛吗|这件产品能用来去除装修带来的甲醛吗|空气净化器pro能去除装修污染吗|空气净化器pro能去除甲醛吗
激光颗粒物传感器是什么|您好，这是一项用来分辨微笑颗粒物，实时反馈空气质量的技术|能给我介绍一下什么是激光颗粒传感器吗|什么是激光颗粒传感器|能介绍一下激光传感器吗|激光颗粒传感器是什么技术|我想了解一下激光颗粒传感器
屏幕会太亮了吗|您好，空气净化器pro有自动亮度调节功能|屏幕亮度怎么调节|屏幕会过亮导致夜间无法入睡吗|屏幕亮光会干扰到休息吗|如何调节屏幕亮度|屏幕亮度会干扰正常生活吗
空气净化器pro达到国家标准了吗|您好，空气净化器pro符合各项标准，请放心使用|这件产品符合国家标准吗|这件产品达标了吗|空气净化器pro符合国标吗|这件产品质量上过关吗|空气净化器pro质量上达标吗
空气净化器pro能放在有婴儿的房间吗|您好，可以的，但请注意不要让婴儿意外操作|空气净化器pro能放在婴儿房吗|婴儿房能放空气净化器pro吗|母婴房能放空气净化器pro吗|空气净化器pro能用于净化婴儿房吗|空气净化器能放在有婴儿的地方吗
如何读取空气净化器pro的数值|您好，有专门的OLED屏幕精确显示空气质量和工作状态|如何查看当前空气质量|怎样通过空气净化器pro读取空气质量|我怎样通过空气净化器pro了解空气质量|怎样了解到空气净化器pro净化后的空气质量|怎样查看当前空气质量
空气净化器pro连续可以开多久|您好，一直开着都没问题的|空气净化器pro能一直开着吗|空气净化器pro能不间断工作吗|空气净化器pro工作一段时间后，要关机吗|空气净化器pro多就关机一次|空气净化器pro多久重启
空气净化器pro可以过滤花粉吗|您好，这样的小颗粒也可以过滤|空气净化器pro能拿来去除花粉吗|我能用空气净化器pro净化花粉吗|空气净化器pro能净化花粉吗|空气净化器pro对花粉有效果吗|空气中的花粉也可以过滤吗
空气净化器pro可以去除甲醛吗|您好，空气净化器pro的滤芯功能强大，可以的|空气净化器pro能去除装修污染吗|空气净化器pro能过滤甲醛吗|我能用空气净化器pro去除甲醛吗|空气净化器pro能吸收甲醛吗|空气进化器pro能吸附装修污染吗
空气净化器pro可以去除毛发吗|您好，空气净化器pro有全新的滤网，可以吸附的|空气净化器pro可以过滤灰尘吗|空气净化器pro可以吸附絮状物吗|空气净化器pro可以去除木屑吗|空气净化器pro能拿来吸附毛发吗|空气净化器pro能吸附灰尘吗
空气净化器pro能除臭吗|您好，空气净化器pro有高品质活性炭，可以的|空气净化器pro能拿来除去厕所臭气吗|空气净化器pro能去除异味吗|空气净化器pro能消除臭味吗|空气净化器pro对臭味有效吗|空气净化器pro对臭味起效吗
空气净化器pro占地大吗|您好，空气净化器pro仅比2代略大一些，但占地也很小|空气净化器pro体积大吗|空气净化器pro会非常大吗|我需要多大的空间放下空气净化器pro|空气净化器pro会放不下吗|空气净化器pro体积怎么样
空气净化器pro能吸收烟味吗|您好，空气净化器pro可以吸收烟味，但吸烟有害健康哦|空气净化器pro对去除烟味有用吗|家里有人吸烟，空气净化器pro有用吗|空气净化器pro对吸烟环境有效吗|空气净化器pro能吸收二手烟吗|空气净化器pro能用来去除烟味吗
空气净化器pro有节能补贴吗|您好，这件产品不在节能补贴的范围内|购买空气净化器pro会获得节能补贴吗|我能享受到节能补贴吗|空气净化器pro享有节能补贴吗|空气净化器pro包含节能补贴吗|空气净化器pro带有节能补贴吗
空气净化器pro可以远程控制吗|您好，可以使用手机APP进行远程智能操控|空气净化器pro支持手机操控吗|我怎样远程操控空气净化器pro|手机上能操作空气净化器pro吗|手机上有APP可以操作空气净化器pro吗|我能通过什么途径远程操控空气净化器pro吗
苹果手机能连接米家APP吗|您好，可以在苹果手机的应用商店里下载米家APP|我是苹果手机，也能智能操控吗|我能用苹果手机操控吗|我能用苹果手机远程控制吗|苹果手机怎么远程操控|IOS系统能连接米家APP吗
空气净化器pro噪音大吗|您好，可以开启睡眠模式，几乎没有噪音|空气净化器pro吵吗|空气净化器pro声音很响吗|空气净化器pro声音大吗|空气净化器pro会制造噪音吗|空气净化器pro会吵到睡眠吗
我怎么调节空气净化器pro|您好，您可以开启自动挡模式，产品会自动调节|怎样在不同的场景下使用空气净化器pro|空气净化器pro怎样应对不同的场景|空气净化器pro怎么在不同的场合使用|如何在不同场合用空气净化器pro|我怎么调节空气净化器pro以应对不同场合
空气净化器pro保修吗|您好，请留意保修日期，并去到对应的维修地点即可|空气净化器pro怎么维修|空气净化器pro带有保修服务吗|空气净化器pro享有保修服务吗|我购买了空气净化器后有保修吗|空气净化器pro的保修服务是怎样的
小米空气净化器pro有货吗|您好，您可以在在线商城查看相关信息|空气净化器pro现在有货吗|我如何知道空气净化器pro现在是否有货|空气净化器pro现在有库存吗|能告诉我一下空气净化器pro现在有货吗|我想了解一下空气净化器pro现在是否有货
空气净化器pro能退货吗|您好，这件商品支持7天无理由退货|空气净化器pro的退货服务怎样|若是对空气净化器pro不满意，能退货吗|空气净化器pro的退货政策是怎样的|我能退货空气净化器pro吗|空气净化器pro的退货保障是怎样的
空气净化器pro能更换吗|您好，这件商品支持15天免费换货|空气净化器pro的换货服务是怎样的|若是对空气净化器pro不满意，能更换吗|空气净化器pro能更换吗|我能更换不满意的空气净化器pro吗|空气净化器pro的换货政策是怎样的
空气净化器pro包邮吗|您好，购物满150元就可包邮|空气净化器pro邮费可以免吗|购物满多少钱包邮费呢|如何才能包邮呢|这件产品包邮吗|空气净化器pro邮费要额外算吗
您好，我想了解一下小米净水器|您好，关于净水器的问题，什么都可以问我哦|能给我介绍一下净水器吗|我想咨询一下净水器这款产品|我有一些问题，关于净水器这款产品|我想问一些关于净水器的问题|我想询问一下净水器的信息
净水器现在的售价多少|您好，小米净水器当前售价为1999元|净水器的价位如何|我想了解一下净水器的价位|能告诉我一下净水器的当前售价吗|净水器一件多少钱|净水器目前的售价是多少
购买净水器要出服务费吗|您好，服务费包括在售价当中了|我需要额外出服务费吗|装机的服务费要另算吗|安装要收取额外的费用吗|安装净水器要额外收取费用吗|安装费用要额外算吗
购买净水器要自行安装吗|您好，我们有专业的人员会上门服务|我需要自己安装净水器吗|净水器需要自己安装吗|我不会安装净水器怎么办|要另外出钱安装净水器吗|我需要去哪里找安装人员
净化后的水质怎样|您好，净化后的水质很好，请放心使用|我不放心净化后的水质怎么办|净化后的水质信得过吗|水质怎样|净水器的水质如何|我能放心净化后的水质吗
净水器占地大吗|您好，净水器的体积不大，可以放在水槽之下|净水器体积大吗|净水器在厨房里放的下吗|我需要多大的地方放下净水器|净水机要放在哪里|净水机要多大的地方才能放下
这一款净水器是什么类型的|您好，这一款净水器的厨下式净水器|这是什么款式的净水器|能告诉我一下净水器的款式吗|我想了解一下这款净水器的款式|我想了解一下这款净水器的种类|这一件净水器是什么品种的
这一款净水器流量有多大|您好，这一款净水器流量最大可以到达400加仑|净水器流量有多大|净水器的流量快吗|我想知道净水器的流量有多大|我想了解一下净水器的流量|能给我介绍一下净水器的流量大小吗
我需要储水吗|您好，我们的净水器由于流量大，无需储水|我需要储存水来净水吗|需要储存多少水来净水|净水需要额外储存水吗|这是储水式净水器吗|这款净水器需要额外储水吗
有二次污染吗|您好，由于流量大，我们的净水器避免了二次污染|我需要担心二次污染吗|净水过程中会有二次污染吗|净水时会存在二次污染吗|二次污染会发生吗|整个过程中会有二次污染吗
净化后的水能用来做饭吗|您好，完全可以，请放心使用|我能用净化水做饭吗|能用净化后的水煮饭吗|净化水能用于烹饪吗|煮饭时能用净化水吗|净化水能做饭吗
能直接饮用净化水吗|您好，可以的，净化后的水是直饮水|水可以直饮吗|我能直接喝净化水吗|净化水能直接喝吗|净化水可以不处理直接喝吗|净化水能直接饮用吗
净水器一共有几层过滤|您好，我们的净水器中一共进行了四层过滤|自来水需要经过几层过滤|中途经过了几层过滤|一共发生了几层过滤|我用到的水经过了几层过滤|有几层过滤起到了效果
净水器的原理是什么|您好，我们运用到了RO反渗透技术，可在官网上具体了解|净水器用上了什么黑魔法|能给我介绍一下净水原理吗|净水原理是什么|净水时用到了什么技术|什么技术起到了净水的效果
净水器能去除细菌吗|您好，可以的|我能用净水器去除细菌吗|这款净水器对细菌有效果吗|这款净水器能拿来消灭细菌吗|对细菌有效果吗|细菌也可以过滤掉吗
净水器能去除水垢吗|您好，可以的|我能用净水器去除水垢吗|水垢也可以去除吗|水垢可以消除吗|净水器能过滤水垢吗|净水器对去除水垢有效果吗
净水器能去除重金属污染吗|您好，由于我们的净化原理先进，已经可以做到了|净水器对重金属有效吗|重金属污染可以被去除吗|净水器可以去除水里的重金属污染吗|我需要担心重金属污染吗|重金属污染能被消除吗
净水器能去除抗生素吗|您好，我们的过滤精度很高，可以的|净水器对抗生素有效吗|水里的抗生素也可以被去除吗|净水器可以去除水里的抗生素吗|抗生素可以被吸附吗|净水器对抗生素有效吗
净水器的过滤精度有多少|您好，过滤精度已经到达了0.001微米|过滤精度达到了多少|能介绍一下当前的过滤精度吗|过滤的准确度有多高|我想了解一下当前的过滤精度|现在的过滤精度有多高
会产生很多废水吗|您好，由于采取了智能净化策略，废水比率很低|净水会带来很多废水吗|净水过程中会产生大量废水吗|会有大量废水产生吗|整个过程中会不会一直有废水产生|我需要担心废水的问题吗
出水很慢吗|您好，我们使用了智能纯水提升技术，出水很快|我需要很长时间才能接满水吗|接水很费时间吗|为了获得更好的效果，是不是出水非常慢|出水速度如何|能介绍一下出水的速度吗
长时间使用后是不是流量很小|您好，由于使用了自动冲洗技术，流量衰减不多|流量会衰减的很厉害吗|我需要担心流量衰减吗|长期使用流量衰减很大吗|会不会使用之后出水很慢|出水会变得很慢吗
如果我还想使用自来水怎么办|您好，净水器可以独立于自来水龙头安装|我是不是只能有净水的龙头|我还想用自来水怎么办|自来水是不是没办法用了|如何保留自来水|自来水是不是没有了
怎么查看滤芯的状态|您好，可以通过水龙头的灯光看到滤芯的状态|怎么知道当前净水器的状态|我如何了解净水器的状态|能告诉我一下如何看净水器的状态|如何检查滤芯|需要拆开查看滤芯吗
什么时候需要更换滤芯|您好，水龙头的灯光变成橙色说米滤芯需要更换/清洗|什么时候滤芯需要更换|什么时候滤芯需要清洗|怎么判断滤芯何时需要更换|如何知道滤芯需要清洗|滤芯什么时候要清洗
水龙头会生锈吗|您好，我们使用了不锈钢水龙头|我需要担心生锈问题吗|水龙头用久了会生锈吗|水龙头会生锈污染水质吗|生锈问题需要考虑吗|水龙头随着使用增加会生锈吗
我能通过手机APP查看水质吗|您好，您可以通过小米智能家庭APP查看|有相关的手机APP吗|有办法用手机查看吗|怎么远程监控|远程查看可行吗|有什么手机上查看的方式吗
手机APP哪里是水质|您好，APP上的TDS值即是水质的标准，值越低水越纯|哪里看水质|水质在手机APP哪里|水质在哪里看到|手机APP的哪个参数是水质|水质在手机APP哪里有显示
更换滤芯麻烦吗|您好，不麻烦您可以简单的更换|我怎么更换滤芯|滤芯更换麻烦吗|自助更换滤芯难吗|滤芯更换难度大吗|滤芯更换起来难度大吗
净水器体积有多大|您好，净水器占地大小小于一张A4纸|净水器占地多大|净水器面积大吗|我的橱柜放得下吗|我需要多大的橱柜才能放下|它需要占据多大的橱柜空间
我家能上门服务吗|您好，全国大部分范围都能免费上门服务|我家在服务范围内吗|我家的位置享有上门服务吗|怎么知道我家在不在上门服务范围内|上门服务能到我家吗|我买了就有上门服务吗
安装过程全程免费吗|您好，服务费不再额外收取，但可能有一些材料的费用|我购买后就不要再出一分钱了吗|还有什么额外的费用吗|安装时还要收别的费用吗|有什么额外的费用吗|我买了就有上门服务吗
净水器保修吗|您好，请留意保修日期，并去到对应的维修地点即可|净水器怎么维修|净水器带有保修服务吗|净水器享有保修服务吗|我购买了空气净化器后有保修吗|净水器的保修服务是怎样的
小米净水器有货吗|您好，您可以在在线商城查看相关信息|净水器现在有货吗|我如何知道净水器现在是否有货|净水器现在有库存吗|能告诉我一下净水器现在有货吗|我想了解一下净水器现在是否有货
净水器能退货吗|您好，这件商品支持7天无理由退货|净水器的退货服务怎样|若是对净水器不满意，能退货吗|净水器的退货政策是怎样的|我能退货净水器吗|净水器的退货保障是怎样的
净水器能更换吗|您好，这件商品支持15天免费换货|净水器的换货服务是怎样的|若是对净水器不满意，能更换吗|净水器能更换吗|我能更换不满意的净水器吗|净水器的换货政策是怎样的
净水器包邮吗|您好，购物满150元就可包邮|净水器邮费可以免吗|购物满多少钱包邮费呢|如何才能包邮呢|这件产品包邮吗|净水器邮费要额外算吗
净化后的水需要烧开吗|您好，直饮没有问题，烧开也没有问题|我需要烧开水吗|烧开是必须的吗|一定要再烧开才能喝吗|要烧开了才能喝吗|水接了之后还要再烧开吗
净水器声音大吗|您好，声音不大的|净水器噪音很大吗|净水器使用时会有很大的噪音吗|净水器很吵吗|净水器使用时很吵吗|净水器会吵到人吗
需要预留电源插座吗|您好，需要橱柜里预留一个电源插座|橱柜里要留电源插座吗|有什么需要预留的东西吗|对橱柜有什么要求吗|橱柜有什么硬性要求吗|为了安装，橱柜得满足什么要求
如何知道滤芯更换周期|您好，这个取决于您家中的水质|滤芯更换周期是多久|多久换一次滤芯|滤芯多久更换一次|我想知道一下滤芯更换的周期|滤芯要是用多久更换一次
废水可以怎么用|您好，您可以用废水来冲厕所，浇花|废水只能排掉吗|废水毫无价值吗|废水毫无用处吗|我能用废水干什么吗|废水只能扔掉吗
净水器耗电量高吗|您好，净水器耗电量很合理|净水器费电吗|净水器是不是很耗电|净水器开着，电费开销大吗|净水器很浪费电吗|净水器是不是很费电
如何找到安装人员|您好，您可以直接和客服取得联系|如何联系安装人员|我的安装人员在哪|安装人员在哪找|我去哪里找到安装人员|怎么让人上门安装
净水器能去除塑料味吗|您好，可以的|净水器可以滤去塑料味道吗|水中的塑料味可以去除吗|净水器可以消灭塑料味吗|水中的塑料味可以被净化掉吗|水里的塑料味能用净水器去除吗
长期使用后是不是要放一段时间水|您好，机器会自动调节，无需担心|长期使用后要手动放水吗|使用一段时间后要放水来清洁吗|长期使用后是不是要手动处理|我需要手动放水来清洁吗|需要手动放水来消除长期使用的影响吗
我需要购买保修延期吗|您好，这要视具体情况而定|保修延期对我有用吗|能给我讲一下有必要买保修延期吗|保修延期有意义吗|保修延期是一定要买的吗|保修延期是必须的吗
保修延期在那购买|您好，保修延期一般可以在这件产品购买时的相关服务中购买|我在哪里能买到保修延期|保修延期在哪里|哪里可以买到保修延期|在哪里给自己的产品加上保修延期|在哪里给保修延期
净化后的水有气泡吗|您好，若出现这种情况，一般是自来水源有问题，请及时联系当地供水商|我的水里有气泡怎么办|净化后的水出现了气泡|水里出现了气泡怎么办|净化后的水产生了气泡怎么办|水里发现了气泡怎么办
我想单独购买滤芯怎么办|您好，可以到各大在线商城单独购买滤芯哦|滤芯可以单独购买吗|滤芯用久了能单独更换吗|在哪里可以单独买到滤芯|滤芯在哪里购买|哪里可以买到更换用的滤芯
滤芯是一套四个吗|您好，本净水器的四个滤芯都可以单独购买，请根据自己的情况而定|我一次要买齐四个滤芯吗|四个滤芯都要买吗|滤芯是一次购齐一套吗|一套滤芯都要买齐吗|滤芯可以单买吗
如何知道要买哪一个滤芯|您好，可以根据净水器的提示，换下已经无效的滤芯即可|如何确定要更换的是哪一个滤芯|我要更换哪一个滤芯|四层滤芯我需要换哪一层|如何确定换下哪一层滤芯|滤芯要换哪一个
滤芯怎么更换|您好，附送有说明指南，您也可以上网查看在线教程|滤芯怎么手动更换啊|我自己怎么更换滤芯|我不会换滤芯怎么办|滤芯更换有什么教程吗|滤芯更换有教学吗
您好，我想了解一下扫地机器人|您好，关于扫地机器人，有什么想问的呢|能给我介绍一下扫地机器人吗|我想了解一下扫地机器人|关于扫地机器人我有一些问题|您好，我想咨询一下关于扫地机器人的问题|我想询问一下扫地机器人的信息
扫地机器人当前售价是多少|您好，扫地机器人当前售价1699元|能告诉我一下扫地机器人当前的价位吗|扫地机器人现在多贵|能告诉我一下扫地机器人现在卖多少钱吗|扫地机器人现在价位如何|扫地机器人市场售价是多少
扫地机器人保修吗|您好，请留意保修日期，并去到对应的维修地点即可|扫地机器人怎么维修|扫地机器人带有保修服务吗|扫地机器人享有保修服务吗|我购买了空气净化器后有保修吗|扫地机器人的保修服务是怎样的
小米扫地机器人有货吗|您好，您可以在在线商城查看相关信息|扫地机器人现在有货吗|我如何知道扫地机器人现在是否有货|扫地机器人现在有库存吗|能告诉我一下扫地机器人现在有货吗|我想了解一下扫地机器人现在是否有货
扫地机器人能退货吗|您好，这件商品支持7天无理由退货|扫地机器人的退货服务怎样|若是对扫地机器人不满意，能退货吗|扫地机器人的退货政策是怎样的|我能退货扫地机器人吗|扫地机器人的退货保障是怎样的
扫地机器人能更换吗|您好，这件商品支持15天免费换货|扫地机器人的换货服务是怎样的|若是对扫地机器人不满意，能更换吗|扫地机器人能更换吗|我能更换不满意的扫地机器人吗|扫地机器人的换货政策是怎样的
扫地机器人包邮吗|您好，购物满150元就可包邮|扫地机器人邮费可以免吗|购物满多少钱包邮费呢|如何才能包邮呢|这件产品包邮吗|扫地机器人邮费要额外算吗
扫地机器人够智能吗|您好，我们专业团队运用了各项先进技术，您大可放心|扫地机器人聪明吗|扫地机器人会不会非常笨|扫地机器人的智能度如何|扫地机器人靠谱吗|扫地机器人信得过吗
扫地机器人怎么寻路|您好，它运用了多传感器、测距仪以及最新的算法|扫地机器人如何规划路线|扫地机器人怎样找到正确的路|扫地机器人怎么确定路线|扫地机器人怎样决定路线|扫第机器人靠什么找到路线
扫地机器人停下后就不能工作了吗|您好，它支持断点续扫|扫地机器人停下来怎么办|扫地机器人是不是会中途停下|机器人停下来就不再工作了吗|扫地机器人是不是不能让它停下来|它停下来就要重启吗
扫地机器人探测距离有多大|您好，扫地机器人探测范围最大可以达到6米|扫地机器人探测范围有多大|扫地机器人能探测多远|扫地机器人能侦测多远的距离|扫地机器人对多远的位置有效|扫地机器人工作时对多远的位置有效
扫地机器人误差有多大|您好，扫地机器人的误差可以小于等于百分之二|扫地机器人误差大吗|扫地机器人会不会有很大的误差|扫地机器人工作时的误差大吗|扫地机器人工作途中会带来很大的误差吗|扫地过程中误差大吗
扫地机器人性能够吗|您好，扫地机器人有三块独立处理器，性能强劲|扫地机器人处理能力够吗|扫地机器人反应快吗|扫地机器人的处理能力有多强|扫地机器人运算能力有多强|能给我介绍一下扫地机器人的处理性能吗
扫地机器人运用的什么算法|您好，扫地机器人用的是知名的SLAM算法|扫地机器人运用的是什么原理|扫地机器人寻路算法是什么|扫地机器人用什么原理定位|扫地机器人用什么途径定位|扫地机器人靠什么知道自己在哪
扫地机器人需要手动充电吗|您好，扫地机器人在电量较低时会自行返回充电|扫地机器人要搬回去充电吗|扫地机器人会中途没点吗|扫地机器人中途没电了怎么办|怎么应对扫地机器人电量低的情况|扫地机器人怎么充电
扫地机器人充电后怎么继续|您好，扫地机器人会记录上一次停下的位置，自动继续工作|扫地机器人充完电后怎么办|扫地机器人充满电后怎样操作|扫地机器人充电后怎样处理|扫地机器人充完电后怎么继续工作|扫地机器人怎样继续工作
扫地机器人能清洁毛发吗|您好，扫地机器人配有强力的风机，可以的|扫地机器人能清扫毛发吗|扫地机器人能收集毛发吗|毛发也可以被打扫吗|扫地机器人可以吸收毛发吗|扫地机器人对毛发有作用吗
扫地机器人能清洁地板积尘吗|您好，扫地机器人有立体清扫系统，可以的|地板上的积尘可以被清扫吗|地板能被打扫干净吗|扫地机器人能打扫干净地板吗|地板上的灰尘可以被打扫干净吗|地板上囤积的灰尘能打扫干净吗
缝隙和墙角可以被打扫干净吗|您好，扫地机器人有沿墙传感器，可以精准清扫|扫地机器人可以清扫墙角吗|扫地机器人可以打扫缝隙吗|扫地机器人能打扫难以清理的角落吗|墙边的装修粉尘能打扫干净吗|角落里的粉尘能打扫干净吗
扫地机器人的电池可以持续多久|您好，扫地机器人的电池可以续航2.5小时|扫地机器人的续航有多久|能给我介绍一下扫地机器人的续航能力吗|扫地机器人能持续工作多久|扫地机器人的电池性能怎样|扫地机器人的电池续航有多久
扫地机器人的电池安全吗|您好，扫地机器人的电池通过了各项标准且伴有多项保护措施|扫地机器人的电池放心吗|我可以放心使用扫地机器人的电池吗|扫地机器人的电池信得过吗|扫地机器人的电池靠谱吗|扫地机器人的电池不会出事吧
扫地机器人能远程控制吗|您好，您可以使用小米智能家庭APP进行控制|扫地机器人能用手机操控吗|我能远程操控扫地机器人吗|扫地机器人可以用手机APP操控吗|我能用手机操控扫地机器人吗|扫地机器人支持远程控制吗
扫地机器人太吵了怎么办|您好，您可以使用APP开启安静模式|扫地机器人工作的时候噪音太大了怎么办|扫地机器人噪音过大怎么办|扫地机器人怎么降低声音|扫地机器人很吵怎么办|如何把扫地机器人的声音调小
扫地机器人有几个模式|您好，扫地机器人有三个大模式，还包含了三个清扫模式|扫地机器人有几种工作状态|扫地机器人有几种模式|扫地机器人有几种工作模式|扫地机器人有多种模式吗|扫地机器人能进行多模式工作吗
扫地机器人寿命有多长啊|您好，扫地机器人的持续运行寿命可以达到1500小时|扫地机器人多久更换一次|扫地机器人运行多久需要更换|扫地机器人最长寿命可以达到多少|可以告诉我一下扫地机器人的寿命吗|扫地机器人的工作寿命有多长
扫地机器人的工作温度是多少|您好，扫地机器人可以在负五度至四十度的范围内都正常工作|扫地机器人能耐低温吗|扫地机器人能耐高温吗|扫地机器人的可工作温度是多少|扫地机器人的正常工作温度是多少|扫地机器人要在怎样的温度下工作
扫地机器人耐冲击吗|您好，机器人经过耐冲击测试，能经受住50G的冲击|扫地机器人扛得住冲击吗|万一扫地机器人被冲击了怎么办|扫地机器人易碎吗|扫地机器人抗击打吗|扫地机器人防得住击打吗
扫地机器人会不会接触不良|您好，扫地机器人经过了充电接触可靠性测试|扫地机器人充电靠谱吗|扫地机器人充电会接触不良吗|扫地机器人会充不上电吗|扫地机器人会连不上电源吗|扫地机器人会突然充不上电吗
虚拟墙是什么|您好，虚拟墙是用来给扫地机器人提供标识让其绕开的配件|我想让机器人绕开某些地方怎么办|能给我介绍一下虚拟墙吗|虚拟墙是一个什么东西|配件中的虚拟墙是什么|机器人的虚拟墙是什么
配件坏了怎么办|您好，您可以去在线商城购买新的配件进行更换|哪里可以买到新配件|在哪能买到用于更换的配件|配件在哪里购买|零件在哪里购买|机器人的配件去哪里更换
灰尘会漏出来吗|您好，我们采取了独立尘盒设计不会有灰尘洒漏|打扫后的灰尘会漏出来吗|灰尘会洒得到处都是吗|灰尘会四处洒漏吗|灰尘会洒出来吗|灰尘是不是会到处飘飞
扫地机器人能处理女性长发吗|您好，机器人各个关节都有防缠绕设计，处理的很好|女性的脱发可以处理吗|非常长的头发也能处理吗|女性的长发可以处理吗|头发会缠住机器人的关节吗|头发会损坏机器人吗
扫地机器人能扫楼梯吗|您好，扫地机器人不能攀爬，所以不能扫楼梯|能处理楼梯吗|能清扫楼梯吗|扫地机器人能上楼梯吗|扫地机器人能爬楼梯吗|扫地机器人能清扫楼梯上的灰尘吗
扫地机器人能扫地摊吗|您好，扫地机器人不能用于清扫软地毯|扫地机器人对地毯有用吗|扫地机器人对清扫地毯有用吗|扫地机器人能打扫地毯上的灰尘吗|扫地机器人能拿来打扫地毯吗|地摊上的灰尘能被打扫干净吗
扫地机器人会把木地板刮花吗|您好，不会的|扫地机器人会把地板弄坏吗|扫地机器人会损坏地板吗|扫地机器人是不是会破坏木地板|扫地机器人会把木地板损坏吗|扫地机器人对木地板有影响吗
手机断网会中断扫地吗|您好，只要机器人有清扫任务，它会继续进行|APP关闭还能继续扫地吗|WIFI网络断掉还能继续扫地吗|扫地时一定要手机连着吗|手机APP得保持开启才能清扫吗|手机APP得一直连接着才能打扫吗
地上有水也能打扫吗|您好，机器人不具备拖地的功能，最好擦干后再用|地上的水可以打扫吗|厨房里的水可以被清扫吗|水渍也可以被打扫吗|可以用于擦干水渍吗|可以用来清扫积水吗
厨房地上的油污可以清扫吗|您好，机器人不具有拖把的功能|地板上的油渍可以清扫干净吗|可以用来打扫油污吗|机器人可以清洁油污吗|厨房的油污可以用机器人清洁吗|可以用机器人清洁厨房油污吗
多久换一次尘盒|您好，请根据实际情况而定|尘盒多久更换一次|我大概多久倒一次尘盒|多久倒一次灰尘|灰尘多久满一次|尘盒多久填满
配件可以水洗吗|您好，除了滤网，都是塑料制品，均可直接水洗|我能用水清洗机器人的配件吗|机器人的配件可以水洗吗|可以用水清洗机器人的配件吗|机器人的配件怎么清洁|机器人的配件怎么保养
瓜子皮可以打扫吗|您好，可以的|果皮可以打扫吗|花生皮可以打扫吗|果壳可以打扫吗|瓜子皮也可以清洁吗|机器人可以清洁瓜子皮吗
每次打扫都要重新规划线路吗|您好，线路规划是全自动的|每次重新启动要重新规划线路吗|每次重启要重新规划线路吗|路线规划是每次都要进行的吗|要规划了路线后才能打扫吗|路线规划是每次启动都要进行的吗
扫地机器人适用于多大的房间|您好，理论上各种房屋都行，但最好在250平方米内|扫地机器人能用在多大的房间|扫地机器人能打扫多大的房间|多大的房间可以用的扫地机器人|我能用扫地机器人打扫多大的房间|扫地机器人能对多大的面积起效
机器人可以过多高的障碍物|您好，1厘米左右|扫地机器人可以跨越多高的障碍物|扫地机器人能通过多高的地方|多高的障碍物可以通过|扫地机器人能越过多高的地方|扫地机器人可以通过的高度是多少
地上的电源线可越过吗|您好，不行的，会将机器人缠住，可能有危险|机器人可以越过电源线吗|机器人可以顺利通过电源线吗|机器人可以跨过地上的电源线吗|机器人能安全通过电源线吗|机器人可以通过地上的线吗
机器人防跌落吗|您好，有悬崖传感器|机器人会摔下去吗|机器人会从高处落下吗|机器人会从楼梯上摔下来吗|机器人会从高处摔下来吗|机器人会从边界落下吗
您好，我想了解一下电动剃须刀|您好，关于电动剃须刀，有什么想问的呢|能给我介绍一下电动剃须刀吗|我想了解一下电动剃须刀|关于电动剃须刀我有一些问题|您好，我想咨询一下关于电动剃须刀的问题|我想询问一下电动剃须刀的信息
电动剃须刀当前售价是多少|您好，电动剃须刀当前售价199元|能告诉我一下电动剃须刀当前的价位吗|电动剃须刀现在多贵|能告诉我一下电动剃须刀现在卖多少钱吗|电动剃须刀现在价位如何|电动剃须刀市场售价是多少
电动剃须刀保修吗|您好，请留意保修日期，并去到对应的维修地点即可|电动剃须刀怎么维修|电动剃须刀带有保修服务吗|电动剃须刀享有保修服务吗|我购买了空气净化器后有保修吗|电动剃须刀的保修服务是怎样的
小米电动剃须刀有货吗|您好，您可以在在线商城查看相关信息|电动剃须刀现在有货吗|我如何知道电动剃须刀现在是否有货|电动剃须刀现在有库存吗|能告诉我一下电动剃须刀现在有货吗|我想了解一下电动剃须刀现在是否有货
电动剃须刀能退货吗|您好，这件商品支持7天无理由退货|电动剃须刀的退货服务怎样|若是对电动剃须刀不满意，能退货吗|电动剃须刀的退货政策是怎样的|我能退货电动剃须刀吗|电动剃须刀的退货保障是怎样的
电动剃须刀能更换吗|您好，这件商品支持15天免费换货|电动剃须刀的换货服务是怎样的|若是对电动剃须刀不满意，能更换吗|电动剃须刀能更换吗|我能更换不满意的电动剃须刀吗|电动剃须刀的换货政策是怎样的
电动剃须刀包邮吗|您好，购物满150元就可包邮|电动剃须刀邮费可以免吗|购物满多少钱包邮费呢|如何才能包邮呢|这件产品包邮吗|电动剃须刀邮费要额外算吗
电动剃须刀会转吗|您好，剃须刀自适应旋转|电动剃须刀是浮动的吗|剃须刀是浮动处理的吗|剃须刀会自动旋转吗|剃须刀剃须过程自动化吗|剃须刀剃须时会旋转吗
我的脸型也可以用这款剃须刀吗|您好，我们使用了3个刀头，可自适应各种脸型|我的脸型也可以用吗|我的脸型很奇怪也能用吗|剃须刀什么脸型都可以剃吗|什么脸型都适用吗|那些脸型可以用
胡茬刮得干净吗|您好，我们使用了双层刀片，清洁得很到位|胡茬可以清洁干净吗|顽固的胡茬可以清理干净吗|剃须刀对胡茬有效果吗|剃须刀会不会剃不干净胡茬|剃须刀清洁胡茬的效果如何
我的胡须很浓密怎么办|您好，该产品有加速挡位，可以深度清洁|胡须浓密怎么办|我的胡子很多怎么办|大络腮胡怎么办|剃须刀清理浓密的胡须效果好吗|剃须刀刮浓密的胡子能刮干净吗
意外开机怎么办|您好，该产品有旅行锁可以避免误开机|儿童误触开机怎么办|怎样防止误触开机|怎样避免误触开机|怎样防止旅行的时候意外开机|怎样防止意外开机
如何知道要清理胡茬室|您好，该产品有清洗/故障灯，亮起时请及时处理|什么时候要清洗胡茬室|如何判断要更换胡茬室|怎样看出要更换胡茬室|什么样的情况下要更换胡茬室|什么场合需要更换胡茬室
可以干湿双剃吗|您好，该产品支持干湿双剃|干的情况下可以直接剃须吗|剃须刀可以在干的情况下剃须吗|干的情况下剃须会有影响吗|干的情况下剃须会对面部造成伤害吗|干的情况下能用剃须刀吗
剃须刀如何清洗|您好，该产品支持直接用水清洗|剃须刀怎么清洁|我怎么清洗我的剃须刀|清洗方法是什么|剃须刀如何正确的保养|剃须刀怎样清洗
一次充电可以使用多久|您好，一次充电可以使用30次|单次充电可以用多久|充一次电可以用多久|充一次电可以剃几次|单次充电可以使用多少次|充一次电能剃多少次胡子
充电方式是怎样的|您好，该产品是USB充电|能介绍一下剃须刀的充电方式吗|这款剃须刀如何充电|这款产品如何充电|我怎么给剃须刀充电|如何给剃须刀充电
您好，我想了解一下便携剃须刀|您好，关于便携剃须刀，有什么想问的呢|能给我介绍一下便携剃须刀吗|我想了解一下便携剃须刀|关于便携剃须刀我有一些问题|您好，我想咨询一下关于便携剃须刀的问题|我想询问一下便携剃须刀的信息
便携剃须刀当前售价是多少|您好，便携剃须刀当前售价179元|能告诉我一下便携剃须刀当前的价位吗|便携剃须刀现在多贵|能告诉我一下便携剃须刀现在卖多少钱吗|便携剃须刀现在价位如何|便携剃须刀市场售价是多少
便携剃须刀保修吗|您好，请留意保修日期，并去到对应的维修地点即可|便携剃须刀怎么维修|便携剃须刀带有保修服务吗|便携剃须刀享有保修服务吗|我购买了空气净化器后有保修吗|便携剃须刀的保修服务是怎样的
小米便携剃须刀有货吗|您好，您可以在在线商城查看相关信息|便携剃须刀现在有货吗|我如何知道便携剃须刀现在是否有货|便携剃须刀现在有库存吗|能告诉我一下便携剃须刀现在有货吗|我想了解一下便携剃须刀现在是否有货
便携剃须刀能退货吗|您好，这件商品支持7天无理由退货|便携剃须刀的退货服务怎样|若是对便携剃须刀不满意，能退货吗|便携剃须刀的退货政策是怎样的|我能退货便携剃须刀吗|便携剃须刀的退货保障是怎样的
便携剃须刀能更换吗|您好，这件商品支持15天免费换货|便携剃须刀的换货服务是怎样的|若是对便携剃须刀不满意，能更换吗|便携剃须刀能更换吗|我能更换不满意的便携剃须刀吗|便携剃须刀的换货政策是怎样的
便携剃须刀包邮吗|您好，购物满150元就可包邮|便携剃须刀邮费可以免吗|购物满多少钱包邮费呢|如何才能包邮呢|这件产品包邮吗|便携剃须刀邮费要额外算吗
便携剃须刀有多重|您好，便携剃须刀仅有100克|便携剃须刀重吗|能告诉我一下便携剃须刀的重量吗|能介绍一下便携剃须刀的质量吗|这一款便携剃须刀有多重|便携剃须刀有多沉
便携剃须刀有多厚|您好，便携剃须刀仅有13.2毫米|便携剃须刀的厚度是多少|能介绍一下便携剃须刀的厚度吗|能告诉我一下便携剃须刀有多厚吗|这一款便携剃须刀有多厚|便携剃须刀很薄吗
便携剃须刀很吵吗|您好，便携剃须刀的工作音量是65分贝，不吵|便携剃须刀会不会制造很多噪音|便携剃须刀是不是很吵|便携剃须刀工作时吵吗|便携剃须刀的工作音量大吗|便携剃须刀剃须时很吵吗
便携剃须刀清理能力如何|您好，其在剃须效果上不如电动剃须刀|便携剃须刀能清干净大胡茬吗|便携剃须刀能清理长胡子吗|便携剃须刀的剃须能力如何|便携剃须刀能刮去大胡子吗|便携剃须刀对大胡子有效吗
便携剃须刀的充电方式是怎样的|您好，该产品是USB type C充电|能介绍一下便携剃须刀的充电方式吗|这款便携剃须刀如何充电|这款产品如何充电|我怎么给便携剃须刀充电|如何给便携剃须刀充电
充电要用专门的适配器吗|您好，一般的type C接口即可|充电要用专门的充电器吗|便携剃须刀充电要用专门的充电器吗|便携剃须刀充电要用专门的接口吗|充电器要专门购买吗|充电器是特制的吗
您好，我想了解一下恒温电水壶|您好，关于恒温电水壶，有什么想问的呢|能给我介绍一下恒温电水壶吗|我想了解一下恒温电水壶|关于恒温电水壶我有一些问题|您好，我想咨询一下关于恒温电水壶的问题|我想询问一下恒温电水壶的信息
恒温电水壶当前售价是多少|您好，恒温电水壶当前售价199元|能告诉我一下恒温电水壶当前的价位吗|恒温电水壶现在多贵|能告诉我一下恒温电水壶现在卖多少钱吗|恒温电水壶现在价位如何|恒温电水壶市场售价是多少
恒温电水壶保修吗|您好，请留意保修日期，并去到对应的维修地点即可|恒温电水壶怎么维修|恒温电水壶带有保修服务吗|恒温电水壶享有保修服务吗|我购买了空气净化器后有保修吗|恒温电水壶的保修服务是怎样的
小米恒温电水壶有货吗|您好，您可以在在线商城查看相关信息|恒温电水壶现在有货吗|我如何知道恒温电水壶现在是否有货|恒温电水壶现在有库存吗|能告诉我一下恒温电水壶现在有货吗|我想了解一下恒温电水壶现在是否有货
恒温电水壶能退货吗|您好，这件商品支持7天无理由退货|恒温电水壶的退货服务怎样|若是对恒温电水壶不满意，能退货吗|恒温电水壶的退货政策是怎样的|我能退货恒温电水壶吗|恒温电水壶的退货保障是怎样的
恒温电水壶能更换吗|您好，这件商品支持15天免费换货|恒温电水壶的换货服务是怎样的|若是对恒温电水壶不满意，能更换吗|恒温电水壶能更换吗|我能更换不满意的恒温电水壶吗|恒温电水壶的换货政策是怎样的
恒温电水壶包邮吗|您好，购物满150元就可包邮|恒温电水壶邮费可以免吗|购物满多少钱包邮费呢|如何才能包邮呢|这件产品包邮吗|恒温电水壶邮费要额外算吗
恒温电水壶的容量是多少|您好，该产品容量是1.5升大容量|能告诉我一下恒温电水壶的容量吗|恒温电水壶能盛多少水|恒温电水壶能放多少水|恒温电水壶能存多少水|恒温电水壶能烧多少水
恒温电水壶可以保温多久|您好，该产品的智能恒温可以达到12小时|恒温电水壶可以恒温多久|恒温电水壶最长能保温多久|恒温电水壶最长能恒温多久|恒温电水壶保温的时间有多长|恒温电水壶恒温的时间有多长
不同的液体怎么保温|您好，您可以用智能APP设定不同的温度|如何给不同的液体保温|如何设置保温温度|如何设置不同的液体保温温度|如何调节保温温度|怎么给多种液体保温
内胆会对水造成污染吗|您好，内胆使用的是优质不锈钢材料，不会有污染|内胆会有污染吗|内胆会对水质产生影响吗|内胆会影响水质吗|内胆会产生异味吗|内胆会污染水质吗
加热耗时多久|您好，煮沸一壶水仅需5分钟|加热一壶水要多久|加热速度怎样|能介绍一下恒温热水壶的加热速度吗|恒温热水壶的加热速度怎样|恒温热水壶加热耗时吗
恒温热水壶会漏电吗|您好，该产品有三重保护，请放心使用|用手摸热水壶会出触电吗|恒温热水壶干烧会有危险吗|恒温热水壶淋水会漏点吗|恒温热水壶有用点危险吗|恒温热水壶有安全问题吗
恒温热水壶会烫手吗|您好，该产品有双层壶身，隔热不烫手|恒温热水壶会很烫吗|恒温热水壶表面会很烫吗|烧开水后水壶会很烫手吗|烧开水后水壶表面温度很高吗|水壶表面温度会很高吗
还有多少电量|好的，这就为您查寻|还剩多少电|电量剩百分之几|电多不多|电量还能用多久|电池多少电
水质怎么样|污染太严重了 速扔|这水可还行|这水能喝不|这水埋汰不|这水有毒没|这水可以做菜吗
你除了检测水质还能干什么|啥也干不了|你还有什么功能|你还会干啥|我买你有何用|你能检测别的东西吗|你就只能检测水质吗
你对水质是如何划分的|0～1000，数值越低水越干净 |你怎么评价水质的|水质分多少等级|你的水质范围是多少||
水质TDS检测笔多少钱|68元|水质TDS检测笔价格多少|水质TDS检测笔的价格是多少|水质TDS检测笔多贵|我想问下水质TDS检测笔的价格是多少|水质TDS检测笔能告诉我一下价格吗
水质TDS检测笔充电器质量怎么样|肯定是可以信赖的|水质TDS检测笔充电器耐用吗|水质TDS检测笔充电器质量好吗|水质TDS检测笔充电器质量没问题吧|水质TDS检测笔充电器能用的时间应该不短吧|水质TDS检测笔充电器用户评价如何
水质TDS检测笔充电器有优惠吗|抱歉，目前没有优惠哦，请后续关注。|水质TDS检测笔充电器有优惠吗|水质TDS检测笔充电器现在有啥优惠没|水质TDS检测笔充电器能优惠吗|水质TDS检测笔充电器有优惠活动吗|水质TDS检测笔充电器现在有优惠活动吗
水质TDS检测笔充电器多少天之内可以退货|15天无人为损坏，可以包退的|支持退货吗|如果有质量问题能退货吗|买回来多久可以退货|你们可以退货吗|如果不满意可以退货吗
水质TDS检测笔充电器多少天之内可以收到货|1-3天内即可收到货，请耐心等待|多久收货|什么时候可以拿到货|多久可以寄到|最快啥时候可以寄到|最快多久收货
水质TDS检测笔充电器还需要抢购吗|不需要的，您可以直接购买|水质TDS检测笔充电器现在可以买吗|水质TDS检测笔充电器有现货吗|水质TDS检测笔充电器能不能马上买|水质TDS检测笔充电器现在买得到吗|水质TDS检测笔充电器官网要抢购吗
水质TDS检测笔充电器今天买了，啥时候可以发货|我们会尽快安排，24小时内即可发货|啥时候发货啊|今天可以发货吗|今天可以寄吗|最快啥时候可以收到|今天能发货吗
买水质TDS检测笔2有送充电器吗？|小米水质TDS检测笔2的标配中是有这款充电器的哦|买了水质TDS检测笔还需要买充电器吗|买的水质TDS检测笔包括充电器吗|买的水质TDS检测笔包含充电器吗|买的水质TDS检测笔自带充电器吗|充电器还需要单独买吗
水质TDS检测笔充电器的长度是多少|17厘米|水质TDS检测笔充电器有多长|水质TDS检测笔充电器多长啊|水质TDS检测笔充电器多短啊|水质TDS检测笔充电器有多短|水质TDS检测笔充电器的长度
水质TDS检测笔的粗是多少|2.8厘米|水质TDS检测笔的线径是多少厘米|水质TDS检测笔的线径是多少毫米|水质TDS检测笔的线径有几毫米|水质TDS检测笔的线径数据是多少|水质TDS检测笔有多粗
你好我想问一下水质TDS检测笔充电器|好的，您问。|你好我想问一下水质TDS检测笔充电器的相关情况|在吗？我想问一下水质TDS检测笔充电器|在吗？我想问一下水质TDS检测笔充电器的相关情况|在吗？你们家的水质TDS检测笔充电器怎么样|你们家的水质TDS检测笔充电器怎么样
充满一次电耗时多久|大概需要半小时|充满一次要多久|充电速度怎么样|能说一下水质TDS检测笔充电器的充电速度吗|水质TDS检测笔充电器的充电速度怎么样|水质TDS检测笔充电器的充电速度快吗
水质TDS检测笔充电器丢了怎么办|可以用手机充电器直接对水质TDS检测笔充电，也可以再购买一个|水质TDS检测笔充电器不见了怎么办|水质TDS检测笔充电器找不到了怎么办|水质TDS检测笔充电器不见了怎么办|水质TDS检测笔充电器遗失了怎么办|水质TDS检测笔充电器找不到了
水质TDS检测笔充电器可以退货吗|可以的，七天内无理由退货|对水质TDS检测笔充电器不满意可以退货吗|水质TDS检测笔充电器可以退换吗|东西买了可以退换吗|发现买错了可以退货吗|买了发现型号不对可以退货吗
水质TDS检测笔充电器包邮吗|购物满150才可以包邮|买够多少钱才可以免邮费|水质TDS检测笔充电器是包邮的吗|水质TDS检测笔充电器还需要付邮费吗|购物满多少钱可以不用付邮费|这个产品包邮吗
水质TDS检测笔一次充电可以使用多久|大约12小时|单次充电可以用多久|充一次电可以用多久|充一次电可以用多长时间|单次充电可以使用多长时间|用多长时间就没电了
开机|好的 这就开机|快开机|速开机|投影电视，快开机|打开投影电视|开开投影电视
播放蜡笔小新第8季|对不起，没有找到|我想看蜡笔小新第8季|快播蜡笔小新第8季|我儿子想看蜡笔小新第8季|我女人想看蜡笔小新第8季|有没有蜡笔小新第8季
关机|好的 这就关机|快关机|速关机|投影电视，快关机|关闭投影电视|我要走了，电视快关机
最近有什么新上的电影|请稍等，正在查询|投影电视，有没有新上架的好电影|投影电视，我想看最近新上的电影|有没有新上的电影|给我找找新上的电影|看看有啥新电影没
激光投影电视有优惠吗|抱歉，目前没有优惠哦，请后续关注。|激光投影电视有优惠吗|激光投影电视现在有啥优惠没|激光投影电视能优惠吗|激光投影电视有优惠活动吗|激光投影电视现在有优惠活动吗
激光投影电视多少天之内可以退货|15天无人为损坏，可以包退的|支持退货吗|如果有质量问题能退货吗|买回来多久可以退货|你们可以退货吗|如果不满意可以退货吗
激光投影电视多少天之内可以收到货|1-3天内即可收到货，请耐心等待|多久收货|什么时候可以拿到货|多久可以寄到|最快啥时候可以寄到|最快多久收货
激光投影电视还需要抢购吗|不需要的，您可以直接购买|激光投影电视现在可以买吗|激光投影电视有现货吗|激光投影电视能不能马上买|激光投影电视现在买得到吗|激光投影电视官网要抢购吗
激光投影电视今天买了，啥时候可以发货|我们会尽快安排，24小时内即可发货|啥时候发货啊|今天可以发货吗|今天可以寄吗|最快啥时候可以收到|今天能发货吗
投影电视支持多少电压|100～240V都可以哦|支持市面电压吗|支持多少电压范围|市面上的电压可以吗|电压会不会不够|适配器要求多大电压
激光投影电视包邮吗|可以包邮|买够多少钱才可以免邮费|激光投影电视是包邮的吗|激光投影电视还需要付邮费吗|购物满多少钱可以不用付邮费|这个产品包邮吗
激光投影电视可以退货吗|可以的，七天内无理由退货|对激光投影电视不满意可以退货吗|激光投影电视可以退换吗|东西买了可以退换吗|发现买错了可以退货吗|买了发现型号不对可以退货吗
激光投影电视充满一次电耗时多久|大概需要半小时|充满一次要多久|充电速度怎么样|能说一下激光投影电视的充电速度吗|激光投影电视的充电速度怎么样|激光投影电视的充电速度快吗
你好我想问一下激光投影电视|好的，您问。|你好我想问一下激光投影电视的相关情况|在吗？我想问一下激光投影电视|在吗？我想问一下激光投影电视的相关情况|在吗？你们家的激光投影电视怎么样|你们家的激光投影电视怎么样
谢谢你的回复，再见|好的，感谢咨询，欢迎下次光临|谢谢|再见|多谢|谢谢你的服务|多谢，拜拜
你好，在吗|您好，有什么可以帮助您|你好啊|在吗|您好|您好，有些问题想请教一下|你好，在忙吗
有几款激光投影电视|总共有2款，您一起买了吧|激光投影电视总共有几款呢|激光投影电视有几种|总共有多少种激光投影电视|可以问一下激光投影电视的种类吗|激光投影电视分几种啊
杭州小米之家有投影电视吗|有的，您可以百度查下地址|杭州小米之家在哪里|小米之家杭州有实体店吗|杭州的小米之家地址在哪|杭州小米之家开了吗|我想去杭州小米之家，有实体店吗
激光投影电视外观好看吗|外观大气简约，您可以在官网查看想要购买类型的示意图哦|激光投影电视看起来怎么样|激光投影电视外观如何|激光投影电视美不美观|激光投影电视好看吗|激光投影电视好不好看
激光投影电视可以自己选择配色吗|不可以，只有黑色和白色|可以自己选择激光投影电视的配色吗|激光投影电视的配色可以自己选吗|能不能自主选择激光投影电视的配色|激光投影电视的配色可以自己DIY吗|激光投影电视有没有不同的配色可以自己选择呢
激光投影电视好用吗|非常好用，使用者体验非常棒|激光投影电视用起来爽吗|激光投影电视用起来方便吗|激光投影电视使用体验如何|激光投影电视好使吗|激光投影电视用起来怎么样
激光投影电视使用寿命长吗|最高可使用高达1000小时哦|激光投影电视可以用多少次|激光投影电视可以用多久|激光投影电视可以用多长时间|激光投影电视使用寿命有多长|激光投影电视大概可以用多长时间
激光投影电视具有配套的使用说明书吗|有的，和货物本身一起寄送过来的哦|买激光投影电视送使用说明书吗|有激光投影电视的使用说明书吗|激光投影电视的使用说明书会一起送吗|激光投影电视的使用说明书会一起寄过来吗|激光投影电视有使用说明书吗
激光投影电视刷配送范围是哪里|这个具体信息可以在官网的配送城市说明里查看~|激光投影电视送得到我家吗|激光投影电视可以送到哪|激光投影电视购配送范围|激光投影电视网购可以送哪|激光投影电视配送范围多大
激光投影电视用户评价咋样|好评如潮啊，可以去官网看下哦|激光投影电视用户评价如何|激光投影电视好评多吗|激光投影电视用户体验咋样|激光投影电视好评的人多吗|激光投影电视好评率高吗
激光投影电视有货吗|您好，您可以在在线商城查看相关信息|激光投影电视现在有货吗|我如何知道激光投影电视现在是否有货|激光投影电视现在有库存吗|能告诉我一下激光投影电视现在有货吗|我想了解一下激光投影电视现在是否有货
充电要用专门的适配器吗|您好，一般的type C接口即可|充电要用专门的充电器吗|激光投影电视充电要用专门的充电器吗|激光投影电视充电要用专门的接口吗|充电器要专门购买吗|充电器是特制的吗
激光投影电视能更换吗|您好，这件商品支持15天免费换货|激光投影电视的换货服务是怎样的|若是对激光投影电视不满意，能更换吗|激光投影电视能更换吗|我能更换不满意的激光投影电视吗|激光投影电视的换货政策是怎样的
激光投影电视如何清洗|您好，该产品支持直接用水清洗|激光投影电视怎么清洁|我怎么清洗我的激光投影电视|清洗方法是什么|激光投影电视如何正确的保养|激光投影电视怎样清洗
我家孩子体温多少度|稍等正在测量|体温多少|体温是否正常|刚才测的体温有多少|体温高吗|体温低吗
对应多少华氏摄氏度|正在为您转换|华氏摄氏度|转换成华氏度|华氏多少度|把摄氏度转成华氏度|体温多少华氏度
华氏度我看不懂|正在转换成摄氏度|我要摄氏度|多少摄氏度|摄氏度体温多少|摄氏体温几度|摄氏度呢
体温是否正常|您测的是哪里的体温|我的体温正常吗|我孩子的体温正常吗|我老婆体温正常吗|体温是不是高了|体温是不是低了
米家体温计测得准吗|测得很准的，欢迎来店里试用|米家体温计准确度怎么样|米家体温计准吗|米家体温计准确率高吗|米家体温计准不准啊|米家体温计靠谱吗
米家体温计是干嘛用的|是用来测量您的体重的哦|米家体温计用途是什么|米家体温计有什么用|米家体温计用来做什么|米家体温计用来干嘛|米家体温计有什么功能
米家体温计质量怎么样|那是相当Ok的|米家体温计质量咋样|米家体温计靠谱吗|米家体温计的屏幕质量怎样|米家体温计显示屏质量怎样|米家体温计显示屏质量靠谱吗
米家体温计有优惠吗|抱歉，目前没有优惠哦，请后续关注。|米家体温计有优惠吗|米家体温计现在有啥优惠没|米家体温计能优惠吗|米家体温计有优惠活动吗|米家体温计现在有优惠活动吗
多大年龄可以用米家体温计|5-150岁都可以的|使用者年龄有没有限制|最大多大岁数可以用|我奶奶可以用吗|我爷爷奶奶可以用吗|米家体温计最大可以称多大岁数
米家体温计尺寸多少|米家体温计是182mm|米家体温计多大|米家体温计长宽高多少|米家体温计面积多大|米家体温计占地方吗|米家体温计会不会很大
米家体温计有多重|米家体温计是19g|米家体温计重量多少|米家体温计多少千克|米家体温计多少kg|米家体温计重不重啊|米家体温计质量多少
米家体温计可以退吗|七天无理由退货哦|米家体温计多久可以退|米家体温计可以无理由退货吗|米家体温计退货是什么样的|米家体温计退货有什么规定吗|米家体温计不喜欢可以退吗
米家体温计保修期多久|保修期为一年，您可以放心使用|米家体温计能保修多久|米家体温计的保修期是多久|我想问下米家体温计能保修多久|米家体温计怎么保修呢|米家体温计保修时间长吗
米家体温计有几种颜色|现在只推出了白色一款|米家体温计啥颜色啊|米家体温计颜色都有些什么|米家体温计颜色多吗|米家体温计有什么颜色可供选择|米家体温计颜色种类
米家体温计送电池吗|标配1节五号电池|米家体温计有配电池吗|米家体温计电池送不送啊|米家体温计电池你们有赠送吗|米家体温计电池免费吗|米家体温计电池一起配送吗
米家体温计怎么供电|需要装1节五号电池|米家体温计是充电吗|米家体温计是电池还是充电|米家体温计要几节电池|米家体温计要几号电池|米家体温计可以充电吗
支不支持华氏和摄氏度|两种温度指标都支持的呢|支持华氏度吗|支持摄氏度吗|能否显示华氏度|能否显示摄氏度|可以在华氏度和摄氏度之间转换吗
米家体温计显示屏是什么|是隐藏式LED显示屏哦|米家体温计显示屏是什么种类的|米家体温计屏幕是什么|米家体温计屏幕清晰吗|米家体温计显示屏好不好啊|米家体温计显示屏是隐藏式的吗
米家体温计滑不滑|米家体温计表面做了防滑纹理，是不会滑的哦|米家体温计容易摔跤吗|米家体温计滑吗|米家体温计防滑吗|米家体温计会不会很滑|米家体温计会让人滑倒吗
米家体温计支持不同体位检测吗|您可以通过APP设置测量位置呢|可以放在身体不同位置测量吗|腋下还是口中|可以放在身体哪里测|机器怎么知道测量的是哪里的体温|体温计如何记录测量身体的位置
米家体温计能测多少人|您想测多少人都可以呢|米家体温计人数有限制吗|米家体温计最多测多少人|米家体温计只能测一个人吗|米家体温计可以和别人一起测吗|米家体温计能存储几个人的数据
米家体温计怎么记录数据|与小米APP搭配，自动上传数据|米家体温计怎么显示数据|米家体温计数据怎么显示|米家体温计的结果在哪看|米家体温计的结果能直接看到吗|米家体温计的数据结果如何显示
米家体温计对手机有要求吗|支持Android4.4和iOS8.0及以上系统的手机|米家体温计对系统有要求吗|米家体温计安卓系统可以用吗|米家体温计苹果手机可以用吗|米家体温计对手机有什么要求|米家体温计系统有版本要求吗
米家体温计精度高吗|您喝杯水都能测出来呢|米家体温计精确度怎么样|米家体温计最多有多精确|米家体温计准吗|米家体温计有多准|米家体温计准确度高不高
米家体温计会不会用久了就不准了|这您放心，米家体温计抗氧化能力很好的|米家体温计保质期有吗|米家体温计会不会失灵|米家体温计用多久会不准|米家体温计的准确度会不会下降|米家体温计会不会老化
米家体温计原理是什么|米家体温计是通过压力传感获得数据的|米家体温计怎么工作|米家体温计工作原理是啥|米家体温计有什么原理|米家体温计为什么能测体脂|米家体温计有什么道理
米家体温计可以换货吗|支持15天无理由换货哦|米家体温计多久可以换货|米家体温计换货有什么规定|米家体温计换货是怎么操作|米家体温计换货有时间限制吗|米家体温计能无理由换货吗
米家体温计包邮吗|需要15元运费|米家体温计邮费多少|米家体温计寄过来要钱吗|米家体温计包不包邮啊|米家体温计邮费贵不贵|米家体温计要不要邮费
米家体温计可以用顺丰吗|米家体温计由小米进行上门配送|米家体温计顺丰多少钱|米家体温计顺丰要加钱吗|米家体温计顺丰要加多少钱|米家体温计用顺丰快递可以吗|米家体温计能不能顺丰
台灯，开机|正在启动|开机吧|快开机|打开台灯|启动台灯|点亮台灯
亮度调低|好的，已为您调低亮度|太亮了，暗一点|别这么亮|暗一点吧|把灯调暗点|太亮了大哥
转换成暖灯|好的，已为您调整光色|变成护眼灯|暖色光源|让光暖一点|我要暖色调|暖光大哥
转换成冷色|好的，已为您调整光色|灯颜色太暖了|让灯光冷峻一点|我要调成冷色调|冷光灯谢谢|冷光灯调整一下
米家LED台灯会不会着火|安全性能您放心|米家LED台灯万一着火怎么办|米家LED台灯会不会导致火灾|米家LED台灯有没有火灾隐患|米家LED台灯万一短路着火怎么办|米家LED台灯易燃吗
米家LED台灯电压多大|220-240V都可以|米家LED台灯额定电压多少|米家LED台灯工作电压范围|米家LED台灯电压范围多少|米家LED台灯需要多大电压|米家LED台灯能在多大电压下工作
米家LED台灯质量怎么样|那是相当Ok的|米家LED台灯质量咋样|米家LED台灯靠谱吗|米家LED台灯质量怎么样|米家LED台灯质量好吗|米家LED台灯质量靠谱吗
米家LED台灯有优惠吗|抱歉，目前没有优惠哦，请后续关注。|米家LED台灯有优惠吗|米家LED台灯现在有啥优惠没|米家LED台灯能优惠吗|米家LED台灯有优惠活动吗|米家LED台灯现在有优惠活动吗
米家LED台灯安全吗|这您放心，请安心使用|米家LED台灯有安全证书吗|米家LED台灯安不安全|米家LED台灯安全性怎么样|米家LED台灯有没有安全隐患|米家LED台灯有没有安全认证
米家LED台灯尺寸多少|32*42*227mm|米家LED台灯多大|米家LED台灯长宽高多少|米家LED台灯面积多大|米家LED台灯占地方吗|米家LED台灯会不会很大
米家LED台灯有多重|水晶版165g，磨砂版160g|米家LED台灯重量多少|米家LED台灯多少千克|米家LED台灯多少kg|米家LED台灯重不重啊|米家LED台灯质量多少
米家LED台灯可以退吗|七天无理由退货哦|米家LED台灯多久可以退|米家LED台灯可以无理由退货吗|米家LED台灯退货是什么样的|米家LED台灯退货有什么规定吗|米家LED台灯不喜欢可以退吗
米家LED台灯保修期多久|保修期为一年，您可以放心使用|米家LED台灯能保修多久|米家LED台灯的保修期是多久|我想问下米家LED台灯能保修多久|米家LED台灯怎么保修呢|米家LED台灯保修时间长吗
米家LED台灯有几种颜色|现在有水晶版和磨砂版供您选择|米家LED台灯啥颜色啊|米家LED台灯颜色都有些什么|米家LED台灯颜色多吗|米家LED台灯有什么颜色可供选择|米家LED台灯颜色种类
米家LED台灯使用有什么要求吗|只要插电就能使用|米家LED台灯使用需要什么条件|米家LED台灯什么时候都能用吗|米家LED台灯使用有什么限制吗|米家LED台灯需要插电线吗|米家LED台灯需要连线吗
米家LED台灯怎么使用|只要与您的手机相连就能使用了哦|米家LED台灯怎么操作|米家LED台灯使用方法|米家LED台灯如何使用|米家LED台灯操作方式|米家LED台灯怎么用
米家LED台灯有几档亮度呢|可以调节不同的冷暖光呢|米家LED台灯有几种亮度|米家LED台灯亮度有几档|米家LED台灯亮度有几种|米家LED台灯只有一种亮度吗|米家LED台灯亮度可以调节吗
米家LED台灯有触电危险吗|这您放心，是非常安全的|米家LED台灯会不会触电啊|米家LED台灯会漏电吗|米家LED台灯不会漏电吧|米家LED台灯是绝缘的吗|用手触摸会触电吗
米家LED台灯怎么调节亮度呢|通过手机APP调节|米家LED台灯如何调节亮度|米家LED台灯怎么改变亮度|米家LED台灯如何改变亮度|米家LED台灯怎么改变光的亮度|米家LED台灯哪里可以调亮度
米家LED台灯对手机有要求吗|支持Android4.4和iOS8.0及以上系统的手机|米家LED台灯支持加湿器吗|米家LED台灯安卓系统可以用吗|米家LED台灯苹果手机可以用吗|米家LED台灯对手机有什么要求|米家LED台灯系统有版本要求吗
米家LED台灯最高亮度多少|水晶版250lm，磨砂版200lm|米家LED台灯最亮有多亮|米家LED台灯最强光有多亮|米家LED台灯最大亮度有多少|米家LED台灯亮吗|米家LED台灯光强度怎么样
米家LED台灯材料是什么|表面是塑料的，坚固又美丽|米家LED台灯什么做的|米家LED台灯灯罩是金属的吗|米家LED台灯灯罩是什么做的|米家LED台灯坚固吗|米家LED台灯耐摔吗
米家LED台灯额定电流多大呢|0.1A|米家LED台灯工作时电流多大|米家LED台灯工作电流大吗|米家LED台灯额定电流大吗|米家LED台灯电流大不大|米家LED台灯工作电流大不大
米家LED台灯几天能到呢|1-3天内即可到货，请耐心等待|什么时候能拿到货|多久可以寄到|最快啥时候可以寄到|最快多久收货|多久收货
米家LED台灯会不会用久了就失灵|这您放心，米家LED台灯抗氧化能力很好的|米家LED台灯保质期有吗|米家LED台灯会不会失灵|米家LED台灯用多久会不准|米家LED台灯的准确度会不会下降|米家LED台灯会不会老化
米家LED台灯好用吗|这是小米的黑科技，用用就知道了|米家LED台灯用起来咋样|米家LED台灯用起来爽吗|米家LED台灯好不好用啊|米家LED台灯用起来怎么样|米家LED台灯使用体验咋样
米家LED台灯可以换货吗|支持15天无理由换货哦|米家LED台灯多久可以换货|米家LED台灯换货有什么规定|米家LED台灯换货是怎么操作|米家LED台灯换货有时间限制吗|米家LED台灯能无理由换货吗
打开摄像头|可以|开机吧，摄像头|开始录像吧|开始记录一点一滴|摄像吧孩子|打开摄像头
把录像记录上传到云端|好的，正在上传数据|把数据上传到云|上传数据|开始上传数据|上传数据到小米云|把本地数据上传到服务器
还有多少存储空间|正在为您查询|内存剩多少了|还剩几个G|本地硬盘还剩多大||
米家小白智能摄像机会不会着火|安全性能您放心|米家小白智能摄像机万一着火怎么办|米家小白智能摄像机会不会导致火灾|米家小白智能摄像机有没有火灾隐患|米家小白智能摄像机万一短路着火怎么办|米家小白智能摄像机易燃吗
米家小白智能摄像机电压多大|100-240V都可以|米家小白智能摄像机额定电压多少|米家小白智能摄像机工作电压范围|米家小白智能摄像机电压范围多少|米家小白智能摄像机需要多大电压|米家小白智能摄像机能在多大电压下工作
米家小白智能摄像机质量怎么样|那是相当Ok的|米家小白智能摄像机质量咋样|米家小白智能摄像机靠谱吗|米家小白智能摄像机质量怎么样|米家小白智能摄像机质量好吗|米家小白智能摄像机质量靠谱吗
米家小白智能摄像机有优惠吗|抱歉，目前没有优惠哦，请后续关注。|米家小白智能摄像机有优惠吗|米家小白智能摄像机现在有啥优惠没|米家小白智能摄像机能优惠吗|米家小白智能摄像机有优惠活动吗|米家小白智能摄像机现在有优惠活动吗
米家小白智能摄像机安全吗|这您放心，请安心使用|米家小白智能摄像机有安全证书吗|米家小白智能摄像机安不安全|米家小白智能摄像机安全性怎么样|米家小白智能摄像机有没有安全隐患|米家小白智能摄像机有没有安全认证
米家小白智能摄像机尺寸多少|高度499mm，厚度54mm|米家小白智能摄像机多大|米家小白智能摄像机长宽高多少|米家小白智能摄像机面积多大|米家小白智能摄像机占地方吗|米家小白智能摄像机会不会很大
米家小白智能摄像机有多重|米家小白智能摄像机大约0.63kg|米家小白智能摄像机重量多少|米家小白智能摄像机多少千克|米家小白智能摄像机多少kg|米家小白智能摄像机重不重啊|米家小白智能摄像机质量多少
米家小白智能摄像机可以退吗|七天无理由退货哦|米家小白智能摄像机多久可以退|米家小白智能摄像机可以无理由退货吗|米家小白智能摄像机退货是什么样的|米家小白智能摄像机退货有什么规定吗|米家小白智能摄像机不喜欢可以退吗
米家小白智能摄像机保修期多久|保修期为一年，您可以放心使用|米家小白智能摄像机能保修多久|米家小白智能摄像机的保修期是多久|我想问下米家小白智能摄像机能保修多久|米家小白智能摄像机怎么保修呢|米家小白智能摄像机保修时间长吗
米家小白智能摄像机有几种颜色|现在只有白色一款|米家小白智能摄像机啥颜色啊|米家小白智能摄像机颜色都有些什么|米家小白智能摄像机颜色多吗|米家小白智能摄像机有什么颜色可供选择|米家小白智能摄像机颜色种类
米家小白智能摄像机使用有什么要求吗|只要插电就能使用|米家小白智能摄像机使用需要什么条件|米家小白智能摄像机什么时候都能用吗|米家小白智能摄像机使用有什么限制吗|米家小白智能摄像机需要插电线吗|米家小白智能摄像机需要连线吗
米家小白智能摄像机怎么使用|只要与您的手机相连就能使用了哦|米家小白智能摄像机怎么操作|米家小白智能摄像机使用方法|米家小白智能摄像机如何使用|米家小白智能摄像机操作方式|米家小白智能摄像机怎么用
米家小白智能摄像机有多大内存|32G，128G都有的亲|内存有多大？|内置存储空间多大|本地硬盘有几个G|能存储多少数据|能够存放几个G的数据
米家小白智能摄像机有触电危险吗|这您放心，是非常安全的|米家小白智能摄像机会不会触电啊|米家小白智能摄像机会漏电吗|米家小白智能摄像机不会漏电吧|米家小白智能摄像机是绝缘的吗|用手触摸会触电吗
米家小白智能摄像机可否把数据备份到云端|可以的，小米云账号免费使用|内存满了可以上传到云吗|可以把本地数据上传吗|可以把视频转存到网上吗|可以与云上数据同步吗|可以将视频数据放到网上备份吗
米家小白智能摄像机对手机有要求吗|支持Android4.4和iOS8.0及以上系统的手机|米家小白智能摄像机对手机系统有什么要求|米家小白智能摄像机安卓系统可以用吗|米家小白智能摄像机苹果手机可以用吗|米家小白智能摄像机对手机有什么要求|米家小白智能摄像机系统有版本要求吗
米家小白智能摄像机最高亮度多少|光通量可达3000lm|米家小白智能摄像机最亮有多亮|米家小白智能摄像机最强光有多亮|米家小白智能摄像机最大亮度有多少|米家小白智能摄像机亮吗|米家小白智能摄像机光强度怎么样
米家小白智能摄像机材料是什么|表面是塑料的，坚固又美丽|米家小白智能摄像机什么做的|米家小白智能摄像机灯罩是金属的吗|米家小白智能摄像机灯罩是什么做的|米家小白智能摄像机坚固吗|米家小白智能摄像机耐摔吗
米家小白智能摄像机额定电流多大呢|0.1A|米家小白智能摄像机工作时电流多大|米家小白智能摄像机工作电流大吗|米家小白智能摄像机额定电流大吗|米家小白智能摄像机电流大不大|米家小白智能摄像机工作电流大不大
米家小白智能摄像机几天能到呢|1-3天内即可到货，请耐心等待|什么时候能拿到货|多久可以寄到|最快啥时候可以寄到|最快多久收获|多久收获
米家小白智能摄像机会不会用久了就失灵|这您放心，米家小白智能摄像机抗氧化能力很好的|米家小白智能摄像机保质期有吗|米家小白智能摄像机会不会失灵|米家小白智能摄像机用多久会不准|米家小白智能摄像机的准确度会不会下降|米家小白智能摄像机会不会老化
可不可以拍摄到老婆偷情|可以，支持红外摄像哦|可不可以拍摄到老公偷情|可不可以拍摄到老伴偷情|可不可以拍摄到儿子乱交|可不可以拍摄到女儿瞎搞|可不可以夜视
米家小白智能摄像机可以换货吗|支持15天无理由换货哦|米家小白智能摄像机多久可以换货|米家小白智能摄像机换货有什么规定|米家小白智能摄像机换货是怎么操作|米家小白智能摄像机换货有时间限制吗|米家小白智能摄像机能无理由换货吗
米家小白智能摄像机包邮吗|除顺丰外都是包邮的呢|米家小白智能摄像机邮费多少|米家小白智能摄像机寄过来要钱吗|米家小白智能摄像机包不包邮啊|米家小白智能摄像机邮费贵不贵|米家小白智能摄像机要不要邮费
米家小白智能摄像机可以用顺丰吗|顺丰邮费请咨询人工客服|米家小白智能摄像机顺丰多少钱|米家小白智能摄像机顺丰要加钱吗|米家小白智能摄像机顺丰要加多少钱|米家小白智能摄像机用顺丰快递可以吗|米家小白智能摄像机能不能顺丰
米家血压计会不会着火|安全性能您放心|米家血压计万一着火怎么办|米家血压计会不会导致火灾|米家血压计有没有火灾隐患|米家血压计万一短路着火怎么办|米家血压计易燃吗
米家血压计电池容量多大|3350mAh充电锂电池|米家血压计是充电还是装电池|米家血压计电池大不大|米家血压计有多大电池容量|米家血压计是什么电池|米家血压计电池可以充电吗
米家血压计质量怎么样|那是相当Ok的|米家血压计质量咋样|米家血压计靠谱吗|米家血压计质量怎么样|米家血压计质量好吗|米家血压计质量靠谱吗
米家血压计有优惠吗|抱歉，目前没有优惠哦，请后续关注。|米家血压计有优惠吗|米家血压计现在有啥优惠没|米家血压计能优惠吗|米家血压计有优惠活动吗|米家血压计现在有优惠活动吗
米家血压计安全吗|这您放心，请安心使用|米家血压计有安全证书吗|米家血压计安不安全|米家血压计安全性怎么样|米家血压计有没有安全隐患|米家血压计有没有安全认证
米家血压计尺寸多少|米家血压计是120.2*25.5*25.5mm|米家血压计多大|米家血压计长宽高多少|米家血压计面积多大|米家血压计占地方吗|米家血压计会不会很大
米家血压计有多重|206g|米家血压计重量多少|米家血压计多少千克|米家血压计多少kg|米家血压计重不重啊|米家血压计质量多少
米家血压计可以退吗|七天无理由退货哦|米家血压计多久可以退|米家血压计可以无理由退货吗|米家血压计退货是什么样的|米家血压计退货有什么规定吗|米家血压计不喜欢可以退吗
米家血压计保修期多久|保修期为一年，您可以放心使用|米家血压计能保修多久|米家血压计的保修期是多久|我想问下米家血压计能保修多久|米家血压计怎么保修呢|米家血压计保修时间长吗
米家血压计有几种颜色|现在只有白色一款|米家血压计啥颜色啊|米家血压计颜色都有些什么|米家血压计颜色多吗|米家血压计有什么颜色可供选择|米家血压计颜色种类
米家血压计使用有什么要求吗|只要有电就能使用|米家血压计使用需要什么条件|米家血压计什么时候都能用吗|米家血压计使用有什么限制吗|米家血压计需要插电线吗|米家血压计需要连线吗
米家血压计怎么使用|请参照以下网址：%&&%¥#@¥|米家血压计怎么操作|米家血压计使用方法|米家血压计如何使用|米家血压计操作方式|米家血压计怎么用
米家血压计我奶奶可以用吗|当然可以，是人就可以用|米家血压计我爷爷可以用吗|米家血压计我妈妈可以用吗|米家血压计我爸爸可以用吗|米家血压计我儿子可以用吗|米家血压计我女儿可以用吗
米家血压计有触电危险吗|这您放心，是非常安全的|米家血压计会不会触电啊|米家血压计会漏电吗|米家血压计不会漏电吧|米家血压计是绝缘的吗|用手触摸会触电吗
米家血压计相对传统血压计有何优势|可以互联网上远程记录和观察哦|产品有何特色|和我之前买的血压计有什么区别|产品相对传统产品有何优势|和我家的血压计有什么区别|米家血压计哪里牛逼
米家血压计续航能力怎么样|充满电一共能用216分钟|米家血压计一共能亮多久|米家血压计亮的久吗|米家血压计续航咋样|米家血压计续航久不久|米家血压计可以亮多长时间
米家血压计测量会不会受气温影响|不会，这你放心|天气是否影响测量结果|测量结果跟温度有关系吗|室内温度可以对测量结果产生影响|冬天和夏天会不会影响血压|血压测量结果会不会受温度影响
米家血压计材料是什么|机身是铝合金的，坚固又美丽|米家血压计什么做的|米家血压计机身是金属的吗|米家血压计机身是什么做的|米家血压计坚固吗|米家血压计耐摔吗
米家血压计方便携带吗|非常方便携带的，小巧轻便|米家血压计能随身带吗|米家血压计可以放进口袋吗|米家血压计携带便捷吗|米家血压计随身带着方便吗|米家血压计轻便吗
米家血压计几天能到呢|1-3天内即可到货，请耐心等待|什么时候能拿到货|多久可以寄到|最快啥时候可以寄到|最快多久收获|多久收获
米家血压计会不会用久了就失灵|这您放心，米家血压计抗氧化能力很好的|米家血压计保质期有吗|米家血压计会不会失灵|米家血压计用多久会不准|米家血压计的准确度会不会下降|米家血压计会不会老化
米家血压计好用吗|这是小米的黑科技，用用就知道了|米家血压计用起来咋样|米家血压计用起来爽吗|米家血压计好不好用啊|米家血压计用起来怎么样|米家血压计使用体验咋样
米家血压计可以换货吗|支持15天无理由换货哦|米家血压计多久可以换货|米家血压计换货有什么规定|米家血压计换货是怎么操作|米家血压计换货有时间限制吗|米家血压计能无理由换货吗
米家血压计包邮吗|除顺丰外都是包邮的呢|米家血压计邮费多少|米家血压计寄过来要钱吗|米家血压计包不包邮啊|米家血压计邮费贵不贵|米家血压计要不要邮费
米家血压计可以用顺丰吗|顺丰邮费请咨询人工客服|米家血压计顺丰多少钱|米家血压计顺丰要加钱吗|米家血压计顺丰要加多少钱|米家血压计用顺丰快递可以吗|米家血压计能不能顺丰
米家飞利浦台灯会不会着火|安全性能您放心|米家飞利浦台灯万一着火怎么办|米家飞利浦台灯会不会导致火灾|米家飞利浦台灯有没有火灾隐患|米家飞利浦台灯万一短路着火怎么办|米家飞利浦台灯易燃吗
米家飞利浦台灯电压多大|220-240V都可以|米家飞利浦台灯额定电压多少|米家飞利浦台灯工作电压范围|米家飞利浦台灯电压范围多少|米家飞利浦台灯需要多大电压|米家飞利浦台灯能在多大电压下工作
米家飞利浦台灯质量怎么样|那是相当Ok的|米家飞利浦台灯质量咋样|米家飞利浦台灯靠谱吗|米家飞利浦台灯质量怎么样|米家飞利浦台灯质量好吗|米家飞利浦台灯质量靠谱吗
米家飞利浦台灯有优惠吗|抱歉，目前没有优惠哦，请后续关注。|米家飞利浦台灯有优惠吗|米家飞利浦台灯现在有啥优惠没|米家飞利浦台灯能优惠吗|米家飞利浦台灯有优惠活动吗|米家飞利浦台灯现在有优惠活动吗
米家飞利浦台灯安全吗|这您放心，请安心使用|米家飞利浦台灯有安全证书吗|米家飞利浦台灯安不安全|米家飞利浦台灯安全性怎么样|米家飞利浦台灯有没有安全隐患|米家飞利浦台灯有没有安全认证
米家飞利浦台灯尺寸多少|42*327mm|米家飞利浦台灯多大|米家飞利浦台灯长宽高多少|米家飞利浦台灯面积多大|米家飞利浦台灯占地方吗|米家飞利浦台灯会不会很大
米家飞利浦台灯有多重|水晶版265g，磨砂版260g|米家飞利浦台灯重量多少|米家飞利浦台灯多少千克|米家飞利浦台灯多少kg|米家飞利浦台灯重不重啊|米家飞利浦台灯质量多少
米家飞利浦台灯可以退吗|七天无理由退货哦|米家飞利浦台灯多久可以退|米家飞利浦台灯可以无理由退货吗|米家飞利浦台灯退货是什么样的|米家飞利浦台灯退货有什么规定吗|米家飞利浦台灯不喜欢可以退吗
米家飞利浦台灯保修期多久|保修期为一年，您可以放心使用|米家飞利浦台灯能保修多久|米家飞利浦台灯的保修期是多久|我想问下米家飞利浦台灯能保修多久|米家飞利浦台灯怎么保修呢|米家飞利浦台灯保修时间长吗
米家飞利浦台灯有几种颜色|现在有水晶版和磨山版供您选择|米家飞利浦台灯啥颜色啊|米家飞利浦台灯颜色都有些什么|米家飞利浦台灯颜色多吗|米家飞利浦台灯有什么颜色可供选择|米家飞利浦台灯颜色种类
米家飞利浦台灯使用有什么要求吗|只要插电就能使用|米家飞利浦台灯使用需要什么条件|米家飞利浦台灯什么时候都能用吗|米家飞利浦台灯使用有什么限制吗|米家飞利浦台灯需要插电线吗|米家飞利浦台灯需要连线吗
米家飞利浦台灯怎么使用|傻逼吧你|米家飞利浦台灯怎么操作|米家飞利浦台灯使用方法|米家飞利浦台灯如何使用|米家飞利浦台灯操作方式|米家飞利浦台灯怎么用
米家飞利浦台灯有几档亮度呢|可以调节不同的冷暖光呢|米家飞利浦台灯有几种亮度|米家飞利浦台灯亮度有几档|米家飞利浦台灯亮度有几种|米家飞利浦台灯只有一种亮度吗|米家飞利浦台灯亮度可以调节吗
米家飞利浦台灯有触电危险吗|这您放心，是非常安全的|米家飞利浦台灯会不会触电啊|米家飞利浦台灯会漏电吗|米家飞利浦台灯不会漏电吧|米家飞利浦台灯是绝缘的吗|用手触摸会触电吗
米家飞利浦台灯怎么调节亮度呢|通过手机APP调节，也可以手动旋钮|米家飞利浦台灯如何调节亮度|米家飞利浦台灯怎么改变亮度|米家飞利浦台灯如何改变亮度|米家飞利浦台灯怎么改变光的亮度|米家飞利浦台灯哪里可以调亮度
米家飞利浦台灯对手机有要求吗|支持Android4.4和iOS8.0及以上系统的手机|米家飞利浦台灯支持加湿器吗|米家飞利浦台灯安卓系统可以用吗|米家飞利浦台灯苹果手机可以用吗|米家飞利浦台灯对手机有什么要求|米家飞利浦台灯系统有版本要求吗
米家飞利浦台灯最高亮度多少|水晶版250lm，磨砂版200lm|米家飞利浦台灯最亮有多亮|米家飞利浦台灯最强光有多亮|米家飞利浦台灯最大亮度有多少|米家飞利浦台灯亮吗|米家飞利浦台灯光强度怎么样
米家飞利浦台灯材料是什么|表面是塑料的，坚固又美丽|米家飞利浦台灯什么做的|米家飞利浦台灯灯罩是金属的吗|米家飞利浦台灯灯罩是什么做的|米家飞利浦台灯坚固吗|米家飞利浦台灯耐摔吗
米家飞利浦台灯额定电流多大呢|0.1A|米家飞利浦台灯工作时电流多大|米家飞利浦台灯工作电流大吗|米家飞利浦台灯额定电流大吗|米家飞利浦台灯电流大不大|米家飞利浦台灯工作电流大不大
米家飞利浦台灯几天能到呢|1-3天内即可到货，请耐心等待|什么时候能拿到货|多久可以寄到|最快啥时候可以寄到|最快多久收货|多久收货
米家飞利浦台灯会不会用久了就失灵|这您放心，米家飞利浦台灯抗氧化能力很好的|米家飞利浦台灯保质期有吗|米家飞利浦台灯会不会失灵|米家飞利浦台灯用多久会不准|米家飞利浦台灯的准确度会不会下降|米家飞利浦台灯会不会老化
米家飞利浦台灯好用吗|这是小米的黑科技，用用就知道了|米家飞利浦台灯用起来咋样|米家飞利浦台灯用起来爽吗|米家飞利浦台灯好不好用啊|米家飞利浦台灯用起来怎么样|米家飞利浦台灯使用体验咋样
米家飞利浦台灯可以换货吗|支持15天无理由换货哦|米家飞利浦台灯多久可以换货|米家飞利浦台灯换货有什么规定|米家飞利浦台灯换货是怎么操作|米家飞利浦台灯换货有时间限制吗|米家飞利浦台灯能无理由换货吗
米家飞利浦台灯包邮吗|除顺丰外满150都是包邮的呢|米家飞利浦台灯邮费多少|米家飞利浦台灯寄过来要钱吗|米家飞利浦台灯包不包邮啊|米家飞利浦台灯邮费贵不贵|米家飞利浦台灯要不要邮费
米家飞利浦台灯可以用顺丰吗|顺丰邮费请咨询人工客服|米家飞利浦台灯顺丰多少钱|米家飞利浦台灯顺丰要加钱吗|米家飞利浦台灯顺丰要加多少钱|米家飞利浦台灯用顺丰快递可以吗|米家飞利浦台灯能不能顺丰
米家智能摄像机云台版有夜视功能吗|具有9m红外夜视功能的呢|米家智能摄像机云台版晚上能工作吗|米家智能摄像机云台版夜视范围多少|米家智能摄像机云台版有红外功能吗|米家智能摄像机云台版夜晚可以工作吗|米家智能摄像机云台版夜晚有红外功能吗
米家智能摄像机云台版视野范围怎么样|有100.4度广角镜头呢|米家智能摄像机云台版看得范围宽吗|米家智能摄像机云台版镜头是广角吗|米家智能摄像机云台版摄影范围咋样|米家智能摄像机云台版摄影范围大吗|米家智能摄像机云台版有多大角度摄影范围
米家智能摄像机云台版质量怎么样|那是相当Ok的|米家智能摄像机云台版质量咋样|米家智能摄像机云台版靠谱吗|米家智能摄像机云台版质量怎么样|米家智能摄像机云台版质量好吗|米家智能摄像机云台版质量靠谱吗
米家智能摄像机云台版有优惠吗|抱歉，目前没有优惠哦，请后续关注。|米家智能摄像机云台版有优惠吗|米家智能摄像机云台版现在有啥优惠没|米家智能摄像机云台版能优惠吗|米家智能摄像机云台版有优惠活动吗|米家智能摄像机云台版现在有优惠活动吗
米家智能摄像机云台版安全吗|这您放心，请安心使用|米家智能摄像机云台版有安全证书吗|米家智能摄像机云台版安不安全|米家智能摄像机云台版安全性怎么样|米家智能摄像机云台版有没有安全隐患|米家智能摄像机云台版有没有安全认证
米家智能摄像机云台版分辨率多少|720p高清|米家智能摄像机云台版清晰吗|米家智能摄像机云台版清晰度多少|米家智能摄像机云台版分辨率多大|米家智能摄像机云台版画面清楚吗|米家智能摄像机云台版画面清晰度咋样
米家智能摄像机云台版有多重|65g|米家智能摄像机云台版重量多少|米家智能摄像机云台版多少千克|米家智能摄像机云台版多少kg|米家智能摄像机云台版重不重啊|米家智能摄像机云台版质量多少
米家智能摄像机云台版可以退吗|七天无理由退货哦|米家智能摄像机云台版多久可以退|米家智能摄像机云台版可以无理由退货吗|米家智能摄像机云台版退货是什么样的|米家智能摄像机云台版退货有什么规定吗|米家智能摄像机云台版不喜欢可以退吗
米家智能摄像机云台版保修期多久|保修期为一年，您可以放心使用|米家智能摄像机云台版能保修多久|米家智能摄像机云台版的保修期是多久|我想问下米家智能摄像机云台版能保修多久|米家智能摄像机云台版怎么保修呢|米家智能摄像机云台版保修时间长吗
米家智能摄像机云台版有几种颜色|现在只有白色一款|米家智能摄像机云台版啥颜色啊|米家智能摄像机云台版颜色都有些什么|米家智能摄像机云台版颜色多吗|米家智能摄像机云台版有什么颜色可供选择|米家智能摄像机云台版颜色种类
米家智能摄像机云台版使用有什么要求吗|只要插电就能使用|米家智能摄像机云台版使用需要什么条件|米家智能摄像机云台版什么时候都能用吗|米家智能摄像机云台版使用有什么限制吗|米家智能摄像机云台版需要插电线吗|米家智能摄像机云台版需要连线吗
米家智能摄像机云台版怎么使用|只要通过蓝牙或WI-FI与您的手机相连就能使用了哦|米家智能摄像机云台版怎么操作|米家智能摄像机云台版使用方法|米家智能摄像机云台版如何使用|米家智能摄像机云台版操作方式|米家智能摄像机云台版怎么用
米家智能摄像机云台版流畅吗|很流畅的，请您放心|米家智能摄像机云台版流畅度怎么样|米家智能摄像机云台版流不流畅|米家智能摄像机云台版画面卡吗|米家智能摄像机云台版画面卡不卡|米家智能摄像机云台版画面流畅度怎么样
米家智能摄像机云台版有触电危险吗|这您放心，是非常安全的|米家智能摄像机云台版会不会触电啊|米家智能摄像机云台版会漏电吗|米家智能摄像机云台版不会漏电吧|米家智能摄像机云台版是绝缘的吗|米家智能摄像机云台版用手触摸会触电吗
多个米家智能摄像机云台版能同时看到吗|支持手机一屏多画面|能同时看到多个画面吗|能用手机看到不同摄像机的画面吗|有很多摄像机怎么办|不同的摄像机的画面能同时看到吗|手机能同时监控多个摄像机吗
米家智能摄像机云台版对手机有要求吗|支持Android4.4和iOS8.0及以上系统的手机|米家智能摄像机云台版对手机系统有要求吗|米家智能摄像机云台版安卓系统可以用吗|米家智能摄像机云台版苹果手机可以用吗|米家智能摄像机云台版对手机有什么要求|米家智能摄像机云台版系统有版本要求吗
米家智能摄像机云台版支持语音吗|支持双向语音沟通|米家智能摄像机云台版能通话吗|米家智能摄像机云台版能语音沟通吗|米家智能摄像机云台版有麦克风吗|米家智能摄像机云台版能记录声音吗|米家智能摄像机云台版能传输声音吗
米家智能摄像机云台版能报警吗|可以侦测画面动态并将警告通知发至手机|米家智能摄像机云台版报警怎么样|米家智能摄像机云台版会自动报警吗|米家智能摄像机云台版会报警吗|米家智能摄像机云台版有自动报警功能吗|米家智能摄像机云台版能发出警报吗
米家智能摄像机云台版能随时关掉吗|可设置休眠时间，保护隐私|米家智能摄像机云台版会破坏隐私吗|米家智能摄像机云台版怎么保护隐私|米家智能摄像机云台版会自动睡眠吗|米家智能摄像机云台版有自动睡眠功能吗|米家智能摄像机云台版能识别家人吗
米家智能摄像机云台版几天能到呢|1-3天内即可到货，请耐心等待|什么时候能拿到货|多久可以寄到|最快啥时候可以寄到|最快多久收货|多久收货
米家智能摄像机云台版会不会用久了就失灵|这您放心，米家智能摄像机云台版抗氧化能力很好的|米家智能摄像机云台版保质期有吗|米家智能摄像机云台版会不会失灵|米家智能摄像机云台版用多久会不准|米家智能摄像机云台版的准确度会不会下降|米家智能摄像机云台版会不会老化
米家智能摄像机云台版好用吗|这是小米的黑科技，用用就知道了|米家智能摄像机云台版用起来咋样|米家智能摄像机云台版用起来爽吗|米家智能摄像机云台版好不好用啊|米家智能摄像机云台版用起来怎么样|米家智能摄像机云台版使用体验咋样
米家智能摄像机云台版可以换货吗|支持15天无理由换货哦|米家智能摄像机云台版多久可以换货|米家智能摄像机云台版换货有什么规定|米家智能摄像机云台版换货是怎么操作|米家智能摄像机云台版换货有时间限制吗|米家智能摄像机云台版能无理由换货吗
智能摄像机云台版支持语音吗|支持双向语音沟通|智能摄像机云台版能通话吗|智能摄像机云台版能语音沟通吗|智能摄像机云台版有麦克风吗|智能摄像机云台版能记录声音吗|智能摄像机云台版能传输声音吗
智能摄像机云台版能报警吗|当然呢，采取分级报警机制，减少无效报警|智能摄像机云台版报警怎么样|智能摄像机云台版会自动报警吗|智能摄像机云台版会报警吗|智能摄像机云台版有自动报警功能吗|智能摄像机云台版能发出警报吗
智能摄像机云台版能随时关掉吗|家人回家后可设置智能睡眠，保护隐私|智能摄像机云台版会破坏隐私吗|智能摄像机云台版怎么保护隐私|智能摄像机云台版会自动睡眠吗|智能摄像机云台版有自动睡眠功能吗|智能摄像机云台版能识别家人吗
还有多少电量|好的，这就为您查寻|还剩多少电|电量剩百分之几|电多不多|电量还能用多久|电池多少电
水质怎么样|污染太严重了 速扔|这水可还行|这水能喝不|这水埋汰不|这水有毒没|这水可以做菜吗
你除了检测水质还能干什么|啥也干不了|你还有什么功能|你还会干啥|我买你有何用|你能检测别的东西吗|你就只能检测水质吗
你对水质是如何划分的|0～1000，数值越低水越干净 |你怎么评价水质的|水质分多少等级|你的水质范围是多少||
水质TDS检测笔多少钱|68元|水质TDS检测笔价格多少|水质TDS检测笔的价格是多少|水质TDS检测笔多贵|我想问下水质TDS检测笔的价格是多少|水质TDS检测笔能告诉我一下价格吗
水质TDS检测笔充电器质量怎么样|肯定是可以信赖的|水质TDS检测笔充电器耐用吗|水质TDS检测笔充电器质量好吗|水质TDS检测笔充电器质量没问题吧|水质TDS检测笔充电器能用的时间应该不短吧|水质TDS检测笔充电器用户评价如何
水质TDS检测笔充电器有优惠吗|抱歉，目前没有优惠哦，请后续关注。|水质TDS检测笔充电器有优惠吗|水质TDS检测笔充电器现在有啥优惠没|水质TDS检测笔充电器能优惠吗|水质TDS检测笔充电器有优惠活动吗|水质TDS检测笔充电器现在有优惠活动吗
水质TDS检测笔充电器多少天之内可以退货|15天无人为损坏，可以包退的|支持退货吗|如果有质量问题能退货吗|买回来多久可以退货|你们可以退货吗|如果不满意可以退货吗
水质TDS检测笔充电器多少天之内可以收到货|1-3天内即可收到货，请耐心等待|多久收货|什么时候可以拿到货|多久可以寄到|最快啥时候可以寄到|最快多久收货
水质TDS检测笔充电器还需要抢购吗|不需要的，您可以直接购买|水质TDS检测笔充电器现在可以买吗|水质TDS检测笔充电器有现货吗|水质TDS检测笔充电器能不能马上买|水质TDS检测笔充电器现在买得到吗|水质TDS检测笔充电器官网要抢购吗
水质TDS检测笔充电器今天买了，啥时候可以发货|我们会尽快安排，24小时内即可发货|啥时候发货啊|今天可以发货吗|今天可以寄吗|最快啥时候可以收到|今天能发货吗
买水质TDS检测笔2有送充电器吗？|小米水质TDS检测笔2的标配中是有这款充电器的哦|买了水质TDS检测笔还需要买充电器吗|买的水质TDS检测笔包括充电器吗|买的水质TDS检测笔包含充电器吗|买的水质TDS检测笔自带充电器吗|充电器还需要单独买吗
水质TDS检测笔充电器的长度是多少|17厘米|水质TDS检测笔充电器有多长|水质TDS检测笔充电器多长啊|水质TDS检测笔充电器多短啊|水质TDS检测笔充电器有多短|水质TDS检测笔充电器的长度
水质TDS检测笔的粗是多少|2.8厘米|水质TDS检测笔的线径是多少厘米|水质TDS检测笔的线径是多少毫米|水质TDS检测笔的线径有几毫米|水质TDS检测笔的线径数据是多少|水质TDS检测笔有多粗
你好我想问一下水质TDS检测笔充电器|好的，您问。|你好我想问一下水质TDS检测笔充电器的相关情况|在吗？我想问一下水质TDS检测笔充电器|在吗？我想问一下水质TDS检测笔充电器的相关情况|在吗？你们家的水质TDS检测笔充电器怎么样|你们家的水质TDS检测笔充电器怎么样
充满一次电耗时多久|大概需要半小时|充满一次要多久|充电速度怎么样|能说一下水质TDS检测笔充电器的充电速度吗|水质TDS检测笔充电器的充电速度怎么样|水质TDS检测笔充电器的充电速度快吗
水质TDS检测笔充电器丢了怎么办|可以用手机充电器直接对水质TDS检测笔充电，也可以再购买一个|水质TDS检测笔充电器不见了怎么办|水质TDS检测笔充电器找不到了怎么办|水质TDS检测笔充电器不见了怎么办|水质TDS检测笔充电器遗失了怎么办|水质TDS检测笔充电器找不到了
水质TDS检测笔充电器可以退货吗|可以的，七天内无理由退货|对水质TDS检测笔充电器不满意可以退货吗|水质TDS检测笔充电器可以退换吗|东西买了可以退换吗|发现买错了可以退货吗|买了发现型号不对可以退货吗
水质TDS检测笔充电器包邮吗|购物满150才可以包邮|买够多少钱才可以免邮费|水质TDS检测笔充电器是包邮的吗|水质TDS检测笔充电器还需要付邮费吗|购物满多少钱可以不用付邮费|这个产品包邮吗
水质TDS检测笔一次充电可以使用多久|大约12小时|单次充电可以用多久|充一次电可以用多久|充一次电可以用多长时间|单次充电可以使用多长时间|用多长时间就没电了
开机|好的 这就开机|快开机|速开机|投影电视，快开机|打开投影电视|开开投影电视
播放蜡笔小新第8季|对不起，没有找到|我想看蜡笔小新第8季|快播蜡笔小新第8季|我儿子想看蜡笔小新第8季|我女人想看蜡笔小新第8季|有没有蜡笔小新第8季
关机|好的 这就关机|快关机|速关机|投影电视，快关机|关闭投影电视|我要走了，电视快关机
最近有什么新上的电影|请稍等，正在查询|投影电视，有没有新上架的好电影|投影电视，我想看最近新上的电影|有没有新上的电影|给我找找新上的电影|看看有啥新电影没
激光投影电视有优惠吗|抱歉，目前没有优惠哦，请后续关注。|激光投影电视有优惠吗|激光投影电视现在有啥优惠没|激光投影电视能优惠吗|激光投影电视有优惠活动吗|激光投影电视现在有优惠活动吗
激光投影电视多少天之内可以退货|15天无人为损坏，可以包退的|支持退货吗|如果有质量问题能退货吗|买回来多久可以退货|你们可以退货吗|如果不满意可以退货吗
激光投影电视多少天之内可以收到货|1-3天内即可收到货，请耐心等待|多久收货|什么时候可以拿到货|多久可以寄到|最快啥时候可以寄到|最快多久收货
激光投影电视还需要抢购吗|不需要的，您可以直接购买|激光投影电视现在可以买吗|激光投影电视有现货吗|激光投影电视能不能马上买|激光投影电视现在买得到吗|激光投影电视官网要抢购吗
激光投影电视今天买了，啥时候可以发货|我们会尽快安排，24小时内即可发货|啥时候发货啊|今天可以发货吗|今天可以寄吗|最快啥时候可以收到|今天能发货吗
投影电视支持多少电压|100～240V都可以哦|支持市面电压吗|支持多少电压范围|市面上的电压可以吗|电压会不会不够|适配器要求多大电压
激光投影电视包邮吗|可以包邮|买够多少钱才可以免邮费|激光投影电视是包邮的吗|激光投影电视还需要付邮费吗|购物满多少钱可以不用付邮费|这个产品包邮吗
激光投影电视可以退货吗|可以的，七天内无理由退货|对激光投影电视不满意可以退货吗|激光投影电视可以退换吗|东西买了可以退换吗|发现买错了可以退货吗|买了发现型号不对可以退货吗
激光投影电视充满一次电耗时多久|大概需要半小时|充满一次要多久|充电速度怎么样|能说一下激光投影电视的充电速度吗|激光投影电视的充电速度怎么样|激光投影电视的充电速度快吗
你好我想问一下激光投影电视|好的，您问。|你好我想问一下激光投影电视的相关情况|在吗？我想问一下激光投影电视|在吗？我想问一下激光投影电视的相关情况|在吗？你们家的激光投影电视怎么样|你们家的激光投影电视怎么样
谢谢你的回复，再见|好的，感谢咨询，欢迎下次光临|谢谢|再见|多谢|谢谢你的服务|多谢，拜拜
你好，在吗|您好，有什么可以帮助您|你好啊|在吗|您好|您好，有些问题想请教一下|你好，在忙吗
有几款激光投影电视|总共有2款，您一起买了吧|激光投影电视总共有几款呢|激光投影电视有几种|总共有多少种激光投影电视|可以问一下激光投影电视的种类吗|激光投影电视分几种啊
杭州小米之家有投影电视吗|有的，您可以百度查下地址|杭州小米之家在哪里|小米之家杭州有实体店吗|杭州的小米之家地址在哪|杭州小米之家开了吗|我想去杭州小米之家，有实体店吗
激光投影电视外观好看吗|外观大气简约，您可以在官网查看想要购买类型的示意图哦|激光投影电视看起来怎么样|激光投影电视外观如何|激光投影电视美不美观|激光投影电视好看吗|激光投影电视好不好看
激光投影电视可以自己选择配色吗|不可以，只有黑色和白色|可以自己选择激光投影电视的配色吗|激光投影电视的配色可以自己选吗|能不能自主选择激光投影电视的配色|激光投影电视的配色可以自己DIY吗|激光投影电视有没有不同的配色可以自己选择呢
激光投影电视好用吗|非常好用，使用者体验非常棒|激光投影电视用起来爽吗|激光投影电视用起来方便吗|激光投影电视使用体验如何|激光投影电视好使吗|激光投影电视用起来怎么样
激光投影电视使用寿命长吗|最高可使用高达1000小时哦|激光投影电视可以用多少次|激光投影电视可以用多久|激光投影电视可以用多长时间|激光投影电视使用寿命有多长|激光投影电视大概可以用多长时间
激光投影电视具有配套的使用说明书吗|有的，和货物本身一起寄送过来的哦|买激光投影电视送使用说明书吗|有激光投影电视的使用说明书吗|激光投影电视的使用说明书会一起送吗|激光投影电视的使用说明书会一起寄过来吗|激光投影电视有使用说明书吗
激光投影电视刷配送范围是哪里|这个具体信息可以在官网的配送城市说明里查看~|激光投影电视送得到我家吗|激光投影电视可以送到哪|激光投影电视购配送范围|激光投影电视网购可以送哪|激光投影电视配送范围多大
激光投影电视用户评价咋样|好评如潮啊，可以去官网看下哦|激光投影电视用户评价如何|激光投影电视好评多吗|激光投影电视用户体验咋样|激光投影电视好评的人多吗|激光投影电视好评率高吗
激光投影电视有货吗|您好，您可以在在线商城查看相关信息|激光投影电视现在有货吗|我如何知道激光投影电视现在是否有货|激光投影电视现在有库存吗|能告诉我一下激光投影电视现在有货吗|我想了解一下激光投影电视现在是否有货
充电要用专门的适配器吗|您好，一般的type C接口即可|充电要用专门的充电器吗|激光投影电视充电要用专门的充电器吗|激光投影电视充电要用专门的接口吗|充电器要专门购买吗|充电器是特制的吗
激光投影电视能更换吗|您好，这件商品支持15天免费换货|激光投影电视的换货服务是怎样的|若是对激光投影电视不满意，能更换吗|激光投影电视能更换吗|我能更换不满意的激光投影电视吗|激光投影电视的换货政策是怎样的
激光投影电视如何清洗|您好，该产品支持直接用水清洗|激光投影电视怎么清洁|我怎么清洗我的激光投影电视|清洗方法是什么|激光投影电视如何正确的保养|激光投影电视怎样清洗
我家孩子体温多少度|稍等正在测量|体温多少|体温是否正常|刚才测的体温有多少|体温高吗|体温低吗
对应多少华氏摄氏度|正在为您转换|华氏摄氏度|转换成华氏度|华氏多少度|把摄氏度转成华氏度|体温多少华氏度
华氏度我看不懂|正在转换成摄氏度|我要摄氏度|多少摄氏度|摄氏度体温多少|摄氏体温几度|摄氏度呢
体温是否正常|您测的是哪里的体温|我的体温正常吗|我孩子的体温正常吗|我老婆体温正常吗|体温是不是高了|体温是不是低了
米家体温计测得准吗|测得很准的，欢迎来店里试用|米家体温计准确度怎么样|米家体温计准吗|米家体温计准确率高吗|米家体温计准不准啊|米家体温计靠谱吗
米家体温计是干嘛用的|是用来测量您的体重的哦|米家体温计用途是什么|米家体温计有什么用|米家体温计用来做什么|米家体温计用来干嘛|米家体温计有什么功能
米家体温计质量怎么样|那是相当Ok的|米家体温计质量咋样|米家体温计靠谱吗|米家体温计的屏幕质量怎样|米家体温计显示屏质量怎样|米家体温计显示屏质量靠谱吗
米家体温计有优惠吗|抱歉，目前没有优惠哦，请后续关注。|米家体温计有优惠吗|米家体温计现在有啥优惠没|米家体温计能优惠吗|米家体温计有优惠活动吗|米家体温计现在有优惠活动吗
多大年龄可以用米家体温计|5-150岁都可以的|使用者年龄有没有限制|最大多大岁数可以用|我奶奶可以用吗|我爷爷奶奶可以用吗|米家体温计最大可以称多大岁数
米家体温计尺寸多少|米家体温计是182mm|米家体温计多大|米家体温计长宽高多少|米家体温计面积多大|米家体温计占地方吗|米家体温计会不会很大
米家体温计有多重|米家体温计是19g|米家体温计重量多少|米家体温计多少千克|米家体温计多少kg|米家体温计重不重啊|米家体温计质量多少
米家体温计可以退吗|七天无理由退货哦|米家体温计多久可以退|米家体温计可以无理由退货吗|米家体温计退货是什么样的|米家体温计退货有什么规定吗|米家体温计不喜欢可以退吗
米家体温计保修期多久|保修期为一年，您可以放心使用|米家体温计能保修多久|米家体温计的保修期是多久|我想问下米家体温计能保修多久|米家体温计怎么保修呢|米家体温计保修时间长吗
米家体温计有几种颜色|现在只推出了白色一款|米家体温计啥颜色啊|米家体温计颜色都有些什么|米家体温计颜色多吗|米家体温计有什么颜色可供选择|米家体温计颜色种类
米家体温计送电池吗|标配1节五号电池|米家体温计有配电池吗|米家体温计电池送不送啊|米家体温计电池你们有赠送吗|米家体温计电池免费吗|米家体温计电池一起配送吗
米家体温计怎么供电|需要装1节五号电池|米家体温计是充电吗|米家体温计是电池还是充电|米家体温计要几节电池|米家体温计要几号电池|米家体温计可以充电吗
支不支持华氏和摄氏度|两种温度指标都支持的呢|支持华氏度吗|支持摄氏度吗|能否显示华氏度|能否显示摄氏度|可以在华氏度和摄氏度之间转换吗
米家体温计显示屏是什么|是隐藏式LED显示屏哦|米家体温计显示屏是什么种类的|米家体温计屏幕是什么|米家体温计屏幕清晰吗|米家体温计显示屏好不好啊|米家体温计显示屏是隐藏式的吗
米家体温计滑不滑|米家体温计表面做了防滑纹理，是不会滑的哦|米家体温计容易摔跤吗|米家体温计滑吗|米家体温计防滑吗|米家体温计会不会很滑|米家体温计会让人滑倒吗
米家体温计支持不同体位检测吗|您可以通过APP设置测量位置呢|可以放在身体不同位置测量吗|腋下还是口中|可以放在身体哪里测|机器怎么知道测量的是哪里的体温|体温计如何记录测量身体的位置
米家体温计能测多少人|您想测多少人都可以呢|米家体温计人数有限制吗|米家体温计最多测多少人|米家体温计只能测一个人吗|米家体温计可以和别人一起测吗|米家体温计能存储几个人的数据
米家体温计怎么记录数据|与小米APP搭配，自动上传数据|米家体温计怎么显示数据|米家体温计数据怎么显示|米家体温计的结果在哪看|米家体温计的结果能直接看到吗|米家体温计的数据结果如何显示
米家体温计对手机有要求吗|支持Android4.4和iOS8.0及以上系统的手机|米家体温计对系统有要求吗|米家体温计安卓系统可以用吗|米家体温计苹果手机可以用吗|米家体温计对手机有什么要求|米家体温计系统有版本要求吗
米家体温计精度高吗|您喝杯水都能测出来呢|米家体温计精确度怎么样|米家体温计最多有多精确|米家体温计准吗|米家体温计有多准|米家体温计准确度高不高
米家体温计会不会用久了就不准了|这您放心，米家体温计抗氧化能力很好的|米家体温计保质期有吗|米家体温计会不会失灵|米家体温计用多久会不准|米家体温计的准确度会不会下降|米家体温计会不会老化
米家体温计原理是什么|米家体温计是通过压力传感获得数据的|米家体温计怎么工作|米家体温计工作原理是啥|米家体温计有什么原理|米家体温计为什么能测体脂|米家体温计有什么道理
米家体温计可以换货吗|支持15天无理由换货哦|米家体温计多久可以换货|米家体温计换货有什么规定|米家体温计换货是怎么操作|米家体温计换货有时间限制吗|米家体温计能无理由换货吗
米家体温计包邮吗|需要15元运费|米家体温计邮费多少|米家体温计寄过来要钱吗|米家体温计包不包邮啊|米家体温计邮费贵不贵|米家体温计要不要邮费
米家体温计可以用顺丰吗|米家体温计由小米进行上门配送|米家体温计顺丰多少钱|米家体温计顺丰要加钱吗|米家体温计顺丰要加多少钱|米家体温计用顺丰快递可以吗|米家体温计能不能顺丰
台灯，开机|正在启动|开机吧|快开机|打开台灯|启动台灯|点亮台灯
亮度调低|好的，已为您调低亮度|太亮了，暗一点|别这么亮|暗一点吧|把灯调暗点|太亮了大哥
转换成暖灯|好的，已为您调整光色|变成护眼灯|暖色光源|让光暖一点|我要暖色调|暖光大哥
转换成冷色|好的，已为您调整光色|灯颜色太暖了|让灯光冷峻一点|我要调成冷色调|冷光灯谢谢|冷光灯调整一下
米家LED台灯会不会着火|安全性能您放心|米家LED台灯万一着火怎么办|米家LED台灯会不会导致火灾|米家LED台灯有没有火灾隐患|米家LED台灯万一短路着火怎么办|米家LED台灯易燃吗
米家LED台灯电压多大|220-240V都可以|米家LED台灯额定电压多少|米家LED台灯工作电压范围|米家LED台灯电压范围多少|米家LED台灯需要多大电压|米家LED台灯能在多大电压下工作
米家LED台灯质量怎么样|那是相当Ok的|米家LED台灯质量咋样|米家LED台灯靠谱吗|米家LED台灯质量怎么样|米家LED台灯质量好吗|米家LED台灯质量靠谱吗
米家LED台灯有优惠吗|抱歉，目前没有优惠哦，请后续关注。|米家LED台灯有优惠吗|米家LED台灯现在有啥优惠没|米家LED台灯能优惠吗|米家LED台灯有优惠活动吗|米家LED台灯现在有优惠活动吗
米家LED台灯安全吗|这您放心，请安心使用|米家LED台灯有安全证书吗|米家LED台灯安不安全|米家LED台灯安全性怎么样|米家LED台灯有没有安全隐患|米家LED台灯有没有安全认证
米家LED台灯尺寸多少|32*42*227mm|米家LED台灯多大|米家LED台灯长宽高多少|米家LED台灯面积多大|米家LED台灯占地方吗|米家LED台灯会不会很大
米家LED台灯有多重|水晶版165g，磨砂版160g|米家LED台灯重量多少|米家LED台灯多少千克|米家LED台灯多少kg|米家LED台灯重不重啊|米家LED台灯质量多少
米家LED台灯可以退吗|七天无理由退货哦|米家LED台灯多久可以退|米家LED台灯可以无理由退货吗|米家LED台灯退货是什么样的|米家LED台灯退货有什么规定吗|米家LED台灯不喜欢可以退吗
米家LED台灯保修期多久|保修期为一年，您可以放心使用|米家LED台灯能保修多久|米家LED台灯的保修期是多久|我想问下米家LED台灯能保修多久|米家LED台灯怎么保修呢|米家LED台灯保修时间长吗
米家LED台灯有几种颜色|现在有水晶版和磨砂版供您选择|米家LED台灯啥颜色啊|米家LED台灯颜色都有些什么|米家LED台灯颜色多吗|米家LED台灯有什么颜色可供选择|米家LED台灯颜色种类
米家LED台灯使用有什么要求吗|只要插电就能使用|米家LED台灯使用需要什么条件|米家LED台灯什么时候都能用吗|米家LED台灯使用有什么限制吗|米家LED台灯需要插电线吗|米家LED台灯需要连线吗
米家LED台灯怎么使用|只要与您的手机相连就能使用了哦|米家LED台灯怎么操作|米家LED台灯使用方法|米家LED台灯如何使用|米家LED台灯操作方式|米家LED台灯怎么用
米家LED台灯有几档亮度呢|可以调节不同的冷暖光呢|米家LED台灯有几种亮度|米家LED台灯亮度有几档|米家LED台灯亮度有几种|米家LED台灯只有一种亮度吗|米家LED台灯亮度可以调节吗
米家LED台灯有触电危险吗|这您放心，是非常安全的|米家LED台灯会不会触电啊|米家LED台灯会漏电吗|米家LED台灯不会漏电吧|米家LED台灯是绝缘的吗|用手触摸会触电吗
米家LED台灯怎么调节亮度呢|通过手机APP调节|米家LED台灯如何调节亮度|米家LED台灯怎么改变亮度|米家LED台灯如何改变亮度|米家LED台灯怎么改变光的亮度|米家LED台灯哪里可以调亮度
米家LED台灯对手机有要求吗|支持Android4.4和iOS8.0及以上系统的手机|米家LED台灯支持加湿器吗|米家LED台灯安卓系统可以用吗|米家LED台灯苹果手机可以用吗|米家LED台灯对手机有什么要求|米家LED台灯系统有版本要求吗
米家LED台灯最高亮度多少|水晶版250lm，磨砂版200lm|米家LED台灯最亮有多亮|米家LED台灯最强光有多亮|米家LED台灯最大亮度有多少|米家LED台灯亮吗|米家LED台灯光强度怎么样
米家LED台灯材料是什么|表面是塑料的，坚固又美丽|米家LED台灯什么做的|米家LED台灯灯罩是金属的吗|米家LED台灯灯罩是什么做的|米家LED台灯坚固吗|米家LED台灯耐摔吗
米家LED台灯额定电流多大呢|0.1A|米家LED台灯工作时电流多大|米家LED台灯工作电流大吗|米家LED台灯额定电流大吗|米家LED台灯电流大不大|米家LED台灯工作电流大不大
米家LED台灯几天能到呢|1-3天内即可到货，请耐心等待|什么时候能拿到货|多久可以寄到|最快啥时候可以寄到|最快多久收货|多久收货
米家LED台灯会不会用久了就失灵|这您放心，米家LED台灯抗氧化能力很好的|米家LED台灯保质期有吗|米家LED台灯会不会失灵|米家LED台灯用多久会不准|米家LED台灯的准确度会不会下降|米家LED台灯会不会老化
米家LED台灯好用吗|这是小米的黑科技，用用就知道了|米家LED台灯用起来咋样|米家LED台灯用起来爽吗|米家LED台灯好不好用啊|米家LED台灯用起来怎么样|米家LED台灯使用体验咋样
米家LED台灯可以换货吗|支持15天无理由换货哦|米家LED台灯多久可以换货|米家LED台灯换货有什么规定|米家LED台灯换货是怎么操作|米家LED台灯换货有时间限制吗|米家LED台灯能无理由换货吗
打开摄像头|可以|开机吧，摄像头|开始录像吧|开始记录一点一滴|摄像吧孩子|打开摄像头
把录像记录上传到云端|好的，正在上传数据|把数据上传到云|上传数据|开始上传数据|上传数据到小米云|把本地数据上传到服务器
还有多少存储空间|正在为您查询|内存剩多少了|还剩几个G|本地硬盘还剩多大||
米家小白智能摄像机会不会着火|安全性能您放心|米家小白智能摄像机万一着火怎么办|米家小白智能摄像机会不会导致火灾|米家小白智能摄像机有没有火灾隐患|米家小白智能摄像机万一短路着火怎么办|米家小白智能摄像机易燃吗
米家小白智能摄像机电压多大|100-240V都可以|米家小白智能摄像机额定电压多少|米家小白智能摄像机工作电压范围|米家小白智能摄像机电压范围多少|米家小白智能摄像机需要多大电压|米家小白智能摄像机能在多大电压下工作
米家小白智能摄像机质量怎么样|那是相当Ok的|米家小白智能摄像机质量咋样|米家小白智能摄像机靠谱吗|米家小白智能摄像机质量怎么样|米家小白智能摄像机质量好吗|米家小白智能摄像机质量靠谱吗
米家小白智能摄像机有优惠吗|抱歉，目前没有优惠哦，请后续关注。|米家小白智能摄像机有优惠吗|米家小白智能摄像机现在有啥优惠没|米家小白智能摄像机能优惠吗|米家小白智能摄像机有优惠活动吗|米家小白智能摄像机现在有优惠活动吗
米家小白智能摄像机安全吗|这您放心，请安心使用|米家小白智能摄像机有安全证书吗|米家小白智能摄像机安不安全|米家小白智能摄像机安全性怎么样|米家小白智能摄像机有没有安全隐患|米家小白智能摄像机有没有安全认证
米家小白智能摄像机尺寸多少|高度499mm，厚度54mm|米家小白智能摄像机多大|米家小白智能摄像机长宽高多少|米家小白智能摄像机面积多大|米家小白智能摄像机占地方吗|米家小白智能摄像机会不会很大
米家小白智能摄像机有多重|米家小白智能摄像机大约0.63kg|米家小白智能摄像机重量多少|米家小白智能摄像机多少千克|米家小白智能摄像机多少kg|米家小白智能摄像机重不重啊|米家小白智能摄像机质量多少
米家小白智能摄像机可以退吗|七天无理由退货哦|米家小白智能摄像机多久可以退|米家小白智能摄像机可以无理由退货吗|米家小白智能摄像机退货是什么样的|米家小白智能摄像机退货有什么规定吗|米家小白智能摄像机不喜欢可以退吗
米家小白智能摄像机保修期多久|保修期为一年，您可以放心使用|米家小白智能摄像机能保修多久|米家小白智能摄像机的保修期是多久|我想问下米家小白智能摄像机能保修多久|米家小白智能摄像机怎么保修呢|米家小白智能摄像机保修时间长吗
米家小白智能摄像机有几种颜色|现在只有白色一款|米家小白智能摄像机啥颜色啊|米家小白智能摄像机颜色都有些什么|米家小白智能摄像机颜色多吗|米家小白智能摄像机有什么颜色可供选择|米家小白智能摄像机颜色种类
米家小白智能摄像机使用有什么要求吗|只要插电就能使用|米家小白智能摄像机使用需要什么条件|米家小白智能摄像机什么时候都能用吗|米家小白智能摄像机使用有什么限制吗|米家小白智能摄像机需要插电线吗|米家小白智能摄像机需要连线吗
米家小白智能摄像机怎么使用|只要与您的手机相连就能使用了哦|米家小白智能摄像机怎么操作|米家小白智能摄像机使用方法|米家小白智能摄像机如何使用|米家小白智能摄像机操作方式|米家小白智能摄像机怎么用
米家小白智能摄像机有多大内存|32G，128G都有的亲|内存有多大？|内置存储空间多大|本地硬盘有几个G|能存储多少数据|能够存放几个G的数据
米家小白智能摄像机有触电危险吗|这您放心，是非常安全的|米家小白智能摄像机会不会触电啊|米家小白智能摄像机会漏电吗|米家小白智能摄像机不会漏电吧|米家小白智能摄像机是绝缘的吗|用手触摸会触电吗
米家小白智能摄像机可否把数据备份到云端|可以的，小米云账号免费使用|内存满了可以上传到云吗|可以把本地数据上传吗|可以把视频转存到网上吗|可以与云上数据同步吗|可以将视频数据放到网上备份吗
米家小白智能摄像机对手机有要求吗|支持Android4.4和iOS8.0及以上系统的手机|米家小白智能摄像机对手机系统有什么要求|米家小白智能摄像机安卓系统可以用吗|米家小白智能摄像机苹果手机可以用吗|米家小白智能摄像机对手机有什么要求|米家小白智能摄像机系统有版本要求吗
米家小白智能摄像机最高亮度多少|光通量可达3000lm|米家小白智能摄像机最亮有多亮|米家小白智能摄像机最强光有多亮|米家小白智能摄像机最大亮度有多少|米家小白智能摄像机亮吗|米家小白智能摄像机光强度怎么样
米家小白智能摄像机材料是什么|表面是塑料的，坚固又美丽|米家小白智能摄像机什么做的|米家小白智能摄像机灯罩是金属的吗|米家小白智能摄像机灯罩是什么做的|米家小白智能摄像机坚固吗|米家小白智能摄像机耐摔吗
米家小白智能摄像机额定电流多大呢|0.1A|米家小白智能摄像机工作时电流多大|米家小白智能摄像机工作电流大吗|米家小白智能摄像机额定电流大吗|米家小白智能摄像机电流大不大|米家小白智能摄像机工作电流大不大
米家小白智能摄像机几天能到呢|1-3天内即可到货，请耐心等待|什么时候能拿到货|多久可以寄到|最快啥时候可以寄到|最快多久收获|多久收获
米家小白智能摄像机会不会用久了就失灵|这您放心，米家小白智能摄像机抗氧化能力很好的|米家小白智能摄像机保质期有吗|米家小白智能摄像机会不会失灵|米家小白智能摄像机用多久会不准|米家小白智能摄像机的准确度会不会下降|米家小白智能摄像机会不会老化
可不可以拍摄到老婆偷情|可以，支持红外摄像哦|可不可以拍摄到老公偷情|可不可以拍摄到老伴偷情|可不可以拍摄到儿子乱交|可不可以拍摄到女儿瞎搞|可不可以夜视
米家小白智能摄像机可以换货吗|支持15天无理由换货哦|米家小白智能摄像机多久可以换货|米家小白智能摄像机换货有什么规定|米家小白智能摄像机换货是怎么操作|米家小白智能摄像机换货有时间限制吗|米家小白智能摄像机能无理由换货吗
米家小白智能摄像机包邮吗|除顺丰外都是包邮的呢|米家小白智能摄像机邮费多少|米家小白智能摄像机寄过来要钱吗|米家小白智能摄像机包不包邮啊|米家小白智能摄像机邮费贵不贵|米家小白智能摄像机要不要邮费
米家小白智能摄像机可以用顺丰吗|顺丰邮费请咨询人工客服|米家小白智能摄像机顺丰多少钱|米家小白智能摄像机顺丰要加钱吗|米家小白智能摄像机顺丰要加多少钱|米家小白智能摄像机用顺丰快递可以吗|米家小白智能摄像机能不能顺丰
米家血压计会不会着火|安全性能您放心|米家血压计万一着火怎么办|米家血压计会不会导致火灾|米家血压计有没有火灾隐患|米家血压计万一短路着火怎么办|米家血压计易燃吗
米家血压计电池容量多大|3350mAh充电锂电池|米家血压计是充电还是装电池|米家血压计电池大不大|米家血压计有多大电池容量|米家血压计是什么电池|米家血压计电池可以充电吗
米家血压计质量怎么样|那是相当Ok的|米家血压计质量咋样|米家血压计靠谱吗|米家血压计质量怎么样|米家血压计质量好吗|米家血压计质量靠谱吗
米家血压计有优惠吗|抱歉，目前没有优惠哦，请后续关注。|米家血压计有优惠吗|米家血压计现在有啥优惠没|米家血压计能优惠吗|米家血压计有优惠活动吗|米家血压计现在有优惠活动吗
米家血压计安全吗|这您放心，请安心使用|米家血压计有安全证书吗|米家血压计安不安全|米家血压计安全性怎么样|米家血压计有没有安全隐患|米家血压计有没有安全认证
米家血压计尺寸多少|米家血压计是120.2*25.5*25.5mm|米家血压计多大|米家血压计长宽高多少|米家血压计面积多大|米家血压计占地方吗|米家血压计会不会很大
米家血压计有多重|206g|米家血压计重量多少|米家血压计多少千克|米家血压计多少kg|米家血压计重不重啊|米家血压计质量多少
米家血压计可以退吗|七天无理由退货哦|米家血压计多久可以退|米家血压计可以无理由退货吗|米家血压计退货是什么样的|米家血压计退货有什么规定吗|米家血压计不喜欢可以退吗
米家血压计保修期多久|保修期为一年，您可以放心使用|米家血压计能保修多久|米家血压计的保修期是多久|我想问下米家血压计能保修多久|米家血压计怎么保修呢|米家血压计保修时间长吗
米家血压计有几种颜色|现在只有白色一款|米家血压计啥颜色啊|米家血压计颜色都有些什么|米家血压计颜色多吗|米家血压计有什么颜色可供选择|米家血压计颜色种类
米家血压计使用有什么要求吗|只要有电就能使用|米家血压计使用需要什么条件|米家血压计什么时候都能用吗|米家血压计使用有什么限制吗|米家血压计需要插电线吗|米家血压计需要连线吗
米家血压计怎么使用|请参照以下网址：%&&%¥#@¥|米家血压计怎么操作|米家血压计使用方法|米家血压计如何使用|米家血压计操作方式|米家血压计怎么用
米家血压计我奶奶可以用吗|当然可以，是人就可以用|米家血压计我爷爷可以用吗|米家血压计我妈妈可以用吗|米家血压计我爸爸可以用吗|米家血压计我儿子可以用吗|米家血压计我女儿可以用吗
米家血压计有触电危险吗|这您放心，是非常安全的|米家血压计会不会触电啊|米家血压计会漏电吗|米家血压计不会漏电吧|米家血压计是绝缘的吗|用手触摸会触电吗
米家血压计相对传统血压计有何优势|可以互联网上远程记录和观察哦|产品有何特色|和我之前买的血压计有什么区别|产品相对传统产品有何优势|和我家的血压计有什么区别|米家血压计哪里牛逼
米家血压计续航能力怎么样|充满电一共能用216分钟|米家血压计一共能亮多久|米家血压计亮的久吗|米家血压计续航咋样|米家血压计续航久不久|米家血压计可以亮多长时间
米家血压计测量会不会受气温影响|不会，这你放心|天气是否影响测量结果|测量结果跟温度有关系吗|室内温度可以对测量结果产生影响|冬天和夏天会不会影响血压|血压测量结果会不会受温度影响
米家血压计材料是什么|机身是铝合金的，坚固又美丽|米家血压计什么做的|米家血压计机身是金属的吗|米家血压计机身是什么做的|米家血压计坚固吗|米家血压计耐摔吗
米家血压计方便携带吗|非常方便携带的，小巧轻便|米家血压计能随身带吗|米家血压计可以放进口袋吗|米家血压计携带便捷吗|米家血压计随身带着方便吗|米家血压计轻便吗
米家血压计几天能到呢|1-3天内即可到货，请耐心等待|什么时候能拿到货|多久可以寄到|最快啥时候可以寄到|最快多久收获|多久收获
米家血压计会不会用久了就失灵|这您放心，米家血压计抗氧化能力很好的|米家血压计保质期有吗|米家血压计会不会失灵|米家血压计用多久会不准|米家血压计的准确度会不会下降|米家血压计会不会老化
米家血压计好用吗|这是小米的黑科技，用用就知道了|米家血压计用起来咋样|米家血压计用起来爽吗|米家血压计好不好用啊|米家血压计用起来怎么样|米家血压计使用体验咋样
米家血压计可以换货吗|支持15天无理由换货哦|米家血压计多久可以换货|米家血压计换货有什么规定|米家血压计换货是怎么操作|米家血压计换货有时间限制吗|米家血压计能无理由换货吗
米家血压计包邮吗|除顺丰外都是包邮的呢|米家血压计邮费多少|米家血压计寄过来要钱吗|米家血压计包不包邮啊|米家血压计邮费贵不贵|米家血压计要不要邮费
米家血压计可以用顺丰吗|顺丰邮费请咨询人工客服|米家血压计顺丰多少钱|米家血压计顺丰要加钱吗|米家血压计顺丰要加多少钱|米家血压计用顺丰快递可以吗|米家血压计能不能顺丰
米家飞利浦台灯会不会着火|安全性能您放心|米家飞利浦台灯万一着火怎么办|米家飞利浦台灯会不会导致火灾|米家飞利浦台灯有没有火灾隐患|米家飞利浦台灯万一短路着火怎么办|米家飞利浦台灯易燃吗
米家飞利浦台灯电压多大|220-240V都可以|米家飞利浦台灯额定电压多少|米家飞利浦台灯工作电压范围|米家飞利浦台灯电压范围多少|米家飞利浦台灯需要多大电压|米家飞利浦台灯能在多大电压下工作
米家飞利浦台灯质量怎么样|那是相当Ok的|米家飞利浦台灯质量咋样|米家飞利浦台灯靠谱吗|米家飞利浦台灯质量怎么样|米家飞利浦台灯质量好吗|米家飞利浦台灯质量靠谱吗
米家飞利浦台灯有优惠吗|抱歉，目前没有优惠哦，请后续关注。|米家飞利浦台灯有优惠吗|米家飞利浦台灯现在有啥优惠没|米家飞利浦台灯能优惠吗|米家飞利浦台灯有优惠活动吗|米家飞利浦台灯现在有优惠活动吗
米家飞利浦台灯安全吗|这您放心，请安心使用|米家飞利浦台灯有安全证书吗|米家飞利浦台灯安不安全|米家飞利浦台灯安全性怎么样|米家飞利浦台灯有没有安全隐患|米家飞利浦台灯有没有安全认证
米家飞利浦台灯尺寸多少|42*327mm|米家飞利浦台灯多大|米家飞利浦台灯长宽高多少|米家飞利浦台灯面积多大|米家飞利浦台灯占地方吗|米家飞利浦台灯会不会很大
米家飞利浦台灯有多重|水晶版265g，磨砂版260g|米家飞利浦台灯重量多少|米家飞利浦台灯多少千克|米家飞利浦台灯多少kg|米家飞利浦台灯重不重啊|米家飞利浦台灯质量多少
米家飞利浦台灯可以退吗|七天无理由退货哦|米家飞利浦台灯多久可以退|米家飞利浦台灯可以无理由退货吗|米家飞利浦台灯退货是什么样的|米家飞利浦台灯退货有什么规定吗|米家飞利浦台灯不喜欢可以退吗
米家飞利浦台灯保修期多久|保修期为一年，您可以放心使用|米家飞利浦台灯能保修多久|米家飞利浦台灯的保修期是多久|我想问下米家飞利浦台灯能保修多久|米家飞利浦台灯怎么保修呢|米家飞利浦台灯保修时间长吗
米家飞利浦台灯有几种颜色|现在有水晶版和磨山版供您选择|米家飞利浦台灯啥颜色啊|米家飞利浦台灯颜色都有些什么|米家飞利浦台灯颜色多吗|米家飞利浦台灯有什么颜色可供选择|米家飞利浦台灯颜色种类
米家飞利浦台灯使用有什么要求吗|只要插电就能使用|米家飞利浦台灯使用需要什么条件|米家飞利浦台灯什么时候都能用吗|米家飞利浦台灯使用有什么限制吗|米家飞利浦台灯需要插电线吗|米家飞利浦台灯需要连线吗
米家飞利浦台灯怎么使用|傻逼吧你|米家飞利浦台灯怎么操作|米家飞利浦台灯使用方法|米家飞利浦台灯如何使用|米家飞利浦台灯操作方式|米家飞利浦台灯怎么用
米家飞利浦台灯有几档亮度呢|可以调节不同的冷暖光呢|米家飞利浦台灯有几种亮度|米家飞利浦台灯亮度有几档|米家飞利浦台灯亮度有几种|米家飞利浦台灯只有一种亮度吗|米家飞利浦台灯亮度可以调节吗
米家飞利浦台灯有触电危险吗|这您放心，是非常安全的|米家飞利浦台灯会不会触电啊|米家飞利浦台灯会漏电吗|米家飞利浦台灯不会漏电吧|米家飞利浦台灯是绝缘的吗|用手触摸会触电吗
米家飞利浦台灯怎么调节亮度呢|通过手机APP调节，也可以手动旋钮|米家飞利浦台灯如何调节亮度|米家飞利浦台灯怎么改变亮度|米家飞利浦台灯如何改变亮度|米家飞利浦台灯怎么改变光的亮度|米家飞利浦台灯哪里可以调亮度
米家飞利浦台灯对手机有要求吗|支持Android4.4和iOS8.0及以上系统的手机|米家飞利浦台灯支持加湿器吗|米家飞利浦台灯安卓系统可以用吗|米家飞利浦台灯苹果手机可以用吗|米家飞利浦台灯对手机有什么要求|米家飞利浦台灯系统有版本要求吗
米家飞利浦台灯最高亮度多少|水晶版250lm，磨砂版200lm|米家飞利浦台灯最亮有多亮|米家飞利浦台灯最强光有多亮|米家飞利浦台灯最大亮度有多少|米家飞利浦台灯亮吗|米家飞利浦台灯光强度怎么样
米家飞利浦台灯材料是什么|表面是塑料的，坚固又美丽|米家飞利浦台灯什么做的|米家飞利浦台灯灯罩是金属的吗|米家飞利浦台灯灯罩是什么做的|米家飞利浦台灯坚固吗|米家飞利浦台灯耐摔吗
米家飞利浦台灯额定电流多大呢|0.1A|米家飞利浦台灯工作时电流多大|米家飞利浦台灯工作电流大吗|米家飞利浦台灯额定电流大吗|米家飞利浦台灯电流大不大|米家飞利浦台灯工作电流大不大
米家飞利浦台灯几天能到呢|1-3天内即可到货，请耐心等待|什么时候能拿到货|多久可以寄到|最快啥时候可以寄到|最快多久收货|多久收货
米家飞利浦台灯会不会用久了就失灵|这您放心，米家飞利浦台灯抗氧化能力很好的|米家飞利浦台灯保质期有吗|米家飞利浦台灯会不会失灵|米家飞利浦台灯用多久会不准|米家飞利浦台灯的准确度会不会下降|米家飞利浦台灯会不会老化
米家飞利浦台灯好用吗|这是小米的黑科技，用用就知道了|米家飞利浦台灯用起来咋样|米家飞利浦台灯用起来爽吗|米家飞利浦台灯好不好用啊|米家飞利浦台灯用起来怎么样|米家飞利浦台灯使用体验咋样
米家飞利浦台灯可以换货吗|支持15天无理由换货哦|米家飞利浦台灯多久可以换货|米家飞利浦台灯换货有什么规定|米家飞利浦台灯换货是怎么操作|米家飞利浦台灯换货有时间限制吗|米家飞利浦台灯能无理由换货吗
米家飞利浦台灯包邮吗|除顺丰外满150都是包邮的呢|米家飞利浦台灯邮费多少|米家飞利浦台灯寄过来要钱吗|米家飞利浦台灯包不包邮啊|米家飞利浦台灯邮费贵不贵|米家飞利浦台灯要不要邮费
米家飞利浦台灯可以用顺丰吗|顺丰邮费请咨询人工客服|米家飞利浦台灯顺丰多少钱|米家飞利浦台灯顺丰要加钱吗|米家飞利浦台灯顺丰要加多少钱|米家飞利浦台灯用顺丰快递可以吗|米家飞利浦台灯能不能顺丰
米家智能摄像机云台版有夜视功能吗|具有9m红外夜视功能的呢|米家智能摄像机云台版晚上能工作吗|米家智能摄像机云台版夜视范围多少|米家智能摄像机云台版有红外功能吗|米家智能摄像机云台版夜晚可以工作吗|米家智能摄像机云台版夜晚有红外功能吗
米家智能摄像机云台版视野范围怎么样|有100.4度广角镜头呢|米家智能摄像机云台版看得范围宽吗|米家智能摄像机云台版镜头是广角吗|米家智能摄像机云台版摄影范围咋样|米家智能摄像机云台版摄影范围大吗|米家智能摄像机云台版有多大角度摄影范围
米家智能摄像机云台版质量怎么样|那是相当Ok的|米家智能摄像机云台版质量咋样|米家智能摄像机云台版靠谱吗|米家智能摄像机云台版质量怎么样|米家智能摄像机云台版质量好吗|米家智能摄像机云台版质量靠谱吗
米家智能摄像机云台版有优惠吗|抱歉，目前没有优惠哦，请后续关注。|米家智能摄像机云台版有优惠吗|米家智能摄像机云台版现在有啥优惠没|米家智能摄像机云台版能优惠吗|米家智能摄像机云台版有优惠活动吗|米家智能摄像机云台版现在有优惠活动吗
米家智能摄像机云台版安全吗|这您放心，请安心使用|米家智能摄像机云台版有安全证书吗|米家智能摄像机云台版安不安全|米家智能摄像机云台版安全性怎么样|米家智能摄像机云台版有没有安全隐患|米家智能摄像机云台版有没有安全认证
米家智能摄像机云台版分辨率多少|720p高清|米家智能摄像机云台版清晰吗|米家智能摄像机云台版清晰度多少|米家智能摄像机云台版分辨率多大|米家智能摄像机云台版画面清楚吗|米家智能摄像机云台版画面清晰度咋样
米家智能摄像机云台版有多重|65g|米家智能摄像机云台版重量多少|米家智能摄像机云台版多少千克|米家智能摄像机云台版多少kg|米家智能摄像机云台版重不重啊|米家智能摄像机云台版质量多少
米家智能摄像机云台版可以退吗|七天无理由退货哦|米家智能摄像机云台版多久可以退|米家智能摄像机云台版可以无理由退货吗|米家智能摄像机云台版退货是什么样的|米家智能摄像机云台版退货有什么规定吗|米家智能摄像机云台版不喜欢可以退吗
米家智能摄像机云台版保修期多久|保修期为一年，您可以放心使用|米家智能摄像机云台版能保修多久|米家智能摄像机云台版的保修期是多久|我想问下米家智能摄像机云台版能保修多久|米家智能摄像机云台版怎么保修呢|米家智能摄像机云台版保修时间长吗
米家智能摄像机云台版有几种颜色|现在只有白色一款|米家智能摄像机云台版啥颜色啊|米家智能摄像机云台版颜色都有些什么|米家智能摄像机云台版颜色多吗|米家智能摄像机云台版有什么颜色可供选择|米家智能摄像机云台版颜色种类
米家智能摄像机云台版使用有什么要求吗|只要插电就能使用|米家智能摄像机云台版使用需要什么条件|米家智能摄像机云台版什么时候都能用吗|米家智能摄像机云台版使用有什么限制吗|米家智能摄像机云台版需要插电线吗|米家智能摄像机云台版需要连线吗
米家智能摄像机云台版怎么使用|只要通过蓝牙或WI-FI与您的手机相连就能使用了哦|米家智能摄像机云台版怎么操作|米家智能摄像机云台版使用方法|米家智能摄像机云台版如何使用|米家智能摄像机云台版操作方式|米家智能摄像机云台版怎么用
米家智能摄像机云台版流畅吗|很流畅的，请您放心|米家智能摄像机云台版流畅度怎么样|米家智能摄像机云台版流不流畅|米家智能摄像机云台版画面卡吗|米家智能摄像机云台版画面卡不卡|米家智能摄像机云台版画面流畅度怎么样
米家智能摄像机云台版有触电危险吗|这您放心，是非常安全的|米家智能摄像机云台版会不会触电啊|米家智能摄像机云台版会漏电吗|米家智能摄像机云台版不会漏电吧|米家智能摄像机云台版是绝缘的吗|米家智能摄像机云台版用手触摸会触电吗
多个米家智能摄像机云台版能同时看到吗|支持手机一屏多画面|能同时看到多个画面吗|能用手机看到不同摄像机的画面吗|有很多摄像机怎么办|不同的摄像机的画面能同时看到吗|手机能同时监控多个摄像机吗
米家智能摄像机云台版对手机有要求吗|支持Android4.4和iOS8.0及以上系统的手机|米家智能摄像机云台版对手机系统有要求吗|米家智能摄像机云台版安卓系统可以用吗|米家智能摄像机云台版苹果手机可以用吗|米家智能摄像机云台版对手机有什么要求|米家智能摄像机云台版系统有版本要求吗
米家智能摄像机云台版支持语音吗|支持双向语音沟通|米家智能摄像机云台版能通话吗|米家智能摄像机云台版能语音沟通吗|米家智能摄像机云台版有麦克风吗|米家智能摄像机云台版能记录声音吗|米家智能摄像机云台版能传输声音吗
米家智能摄像机云台版能报警吗|可以侦测画面动态并将警告通知发至手机|米家智能摄像机云台版报警怎么样|米家智能摄像机云台版会自动报警吗|米家智能摄像机云台版会报警吗|米家智能摄像机云台版有自动报警功能吗|米家智能摄像机云台版能发出警报吗
米家智能摄像机云台版能随时关掉吗|可设置休眠时间，保护隐私|米家智能摄像机云台版会破坏隐私吗|米家智能摄像机云台版怎么保护隐私|米家智能摄像机云台版会自动睡眠吗|米家智能摄像机云台版有自动睡眠功能吗|米家智能摄像机云台版能识别家人吗
米家智能摄像机云台版几天能到呢|1-3天内即可到货，请耐心等待|什么时候能拿到货|多久可以寄到|最快啥时候可以寄到|最快多久收货|多久收货
米家智能摄像机云台版会不会用久了就失灵|这您放心，米家智能摄像机云台版抗氧化能力很好的|米家智能摄像机云台版保质期有吗|米家智能摄像机云台版会不会失灵|米家智能摄像机云台版用多久会不准|米家智能摄像机云台版的准确度会不会下降|米家智能摄像机云台版会不会老化
米家智能摄像机云台版好用吗|这是小米的黑科技，用用就知道了|米家智能摄像机云台版用起来咋样|米家智能摄像机云台版用起来爽吗|米家智能摄像机云台版好不好用啊|米家智能摄像机云台版用起来怎么样|米家智能摄像机云台版使用体验咋样
米家智能摄像机云台版可以换货吗|支持15天无理由换货哦|米家智能摄像机云台版多久可以换货|米家智能摄像机云台版换货有什么规定|米家智能摄像机云台版换货是怎么操作|米家智能摄像机云台版换货有时间限制吗|米家智能摄像机云台版能无理由换货吗
智能摄像机云台版支持语音吗|支持双向语音沟通|智能摄像机云台版能通话吗|智能摄像机云台版能语音沟通吗|智能摄像机云台版有麦克风吗|智能摄像机云台版能记录声音吗|智能摄像机云台版能传输声音吗
智能摄像机云台版能报警吗|当然呢，采取分级报警机制，减少无效报警|智能摄像机云台版报警怎么样|智能摄像机云台版会自动报警吗|智能摄像机云台版会报警吗|智能摄像机云台版有自动报警功能吗|智能摄像机云台版能发出警报吗
智能摄像机云台版能随时关掉吗|家人回家后可设置智能睡眠，保护隐私|智能摄像机云台版会破坏隐私吗|智能摄像机云台版怎么保护隐私|智能摄像机云台版会自动睡眠吗|智能摄像机云台版有自动睡眠功能吗|智能摄像机云台版能识别家人吗
手环充电器多少钱|6.8元|手环充电器价格多少|手环充电器的价格是多少|手环充电器多贵|我想问下手环充电器的价格是多少|手环充电器能告诉我一下价格吗
手环充电器质量怎么样|肯定是可以信赖的|手环充电器耐用吗|手环充电器质量好吗|手环充电器质量没问题吧|手环充电器能用的时间应该不短吧|手环充电器用户评价如何
手环充电器有优惠吗|抱歉，目前没有优惠哦，请后续关注。|手环充电器有优惠吗|手环充电器现在有啥优惠没|手环充电器能优惠吗|手环充电器有优惠活动吗|手环充电器现在有优惠活动吗
手环充电器多少天之内可以退货|15天无人为损坏，可以包退的|支持退货吗|如果有质量问题能退货吗|买回来多久可以退货|你们可以退货吗|如果不满意可以退货吗
手环充电器多少天之内可以收到货|1-3天内即可收到货，请耐心等待|多久收货|什么时候可以拿到货|多久可以寄到|最快啥时候可以寄到|最快多久收货
手环充电器还需要抢购吗|不需要的，您可以直接购买|手环充电器现在可以买吗|手环充电器有现货吗|手环充电器能不能马上买|手环充电器现在买得到吗|手环充电器官网要抢购吗
手环充电器今天买了，啥时候可以发货|我们会尽快安排，24小时内即可发货|啥时候发货啊|今天可以发货吗|今天可以寄吗|最快啥时候可以收到|今天能发货吗
买手环2有送充电器吗？|小米手环2的标配中是有这款充电器的哦|买了手环还需要买充电器吗|买的手环包括充电器吗|买的手环包含充电器吗|买的手环自带充电器吗|充电器还需要单独买吗
手环充电器的长度是多少|17厘米|手环充电器有多长|手环充电器多长啊|手环充电器多短啊|手环充电器有多短|手环充电器的长度
手环的线径是多少|2.8毫米|手环的线径是多少厘米|手环的线径是多少毫米|手环的线径有几毫米|手环的线径数据是多少|手环有多粗
你好我想问一下手环充电器|好的，您问。|你好我想问一下手环充电器的相关情况|在吗？我想问一下手环充电器|在吗？我想问一下手环充电器的相关情况|在吗？你们家的手环充电器怎么样|你们家的手环充电器怎么样
充满一次电耗时多久|大概需要半小时|充满一次要多久|充电速度怎么样|能说一下手环充电器的充电速度吗|手环充电器的充电速度怎么样|手环充电器的充电速度快吗
手环充电器丢了怎么办|可以用手机充电器直接对手环充电，也可以再购买一个|手环充电器不见了怎么办|手环充电器找不到了怎么办|手环充电器不见了怎么办|手环充电器遗失了怎么办|手环充电器找不到了
手环充电器可以退货吗|可以的，七天内无理由退货|对手环充电器不满意可以退货吗|手环充电器可以退换吗|东西买了可以退换吗|发现买错了可以退货吗|买了发现型号不对可以退货吗
手环充电器包邮吗|购物满150才可以包邮|买够多少钱才可以免邮费|手环充电器是包邮的吗|手环充电器还需要付邮费吗|购物满多少钱可以不用付邮费|这个产品包邮吗
手环一次充电可以使用多久|大约12小时|单次充电可以用多久|充一次电可以用多久|充一次电可以用多长时间|单次充电可以使用多长时间|用多长时间就没电了
米家电动牙刷多少钱|199元|米家电动牙刷价格多少|米家电动牙刷的价格是多少|米家电动牙刷多贵+B39AC39:E39|我想问下米家+A37:F38电动牙刷的价格是多少|米家电动牙刷能告诉我一下价格吗
米家电动牙刷有优惠吗|抱歉，目前没有优惠哦，请后续关注。|米家电动牙刷有优惠吗|米家电动牙刷现在有啥优惠没|米家电动牙刷能优惠吗|米家电动牙刷有优惠活动吗|米家电动牙刷现在有优惠活动吗
米家电动牙刷多少天之内可以退货|15天无人为损坏，可以包退的|支持退货吗|如果有质量问题能退货吗|买回来多久可以退货|你们可以退货吗|如果不满意可以退货吗
米家电动牙刷多少天之内可以收到货|1-3天内即可收到货，请耐心等待|多久收货|什么时候可以拿到货|多久可以寄到|最快啥时候可以寄到|最快多久收货
米家电动牙刷还需要抢购吗|不需要的，您可以直接购买|米家电动牙刷现在可以买吗|米家电动牙刷有现货吗|米家电动牙刷能不能马上买|米家电动牙刷现在买得到吗|米家电动牙刷官网要抢购吗
米家电动牙刷今天买了，啥时候可以发货|我们会尽快安排，24小时内即可发货|啥时候发货啊|今天可以发货吗|今天可以寄吗|最快啥时候可以收到|今天能发货吗
米家电动牙刷一次充电可以使用多久|大约12小时|单次充电可以用多久|充一次电可以用多久|充一次电可以用多长时间|单次充电可以使用多长时间|用多长时间就没电了
米家电动牙刷包邮吗|购物满150才可以包邮|买够多少钱才可以免邮费|米家电动牙刷是包邮的吗|米家电动牙刷还需要付邮费吗|购物满多少钱可以不用付邮费|这个产品包邮吗
米家电动牙刷可以退货吗|可以的，七天内无理由退货|对米家电动牙刷不满意可以退货吗|米家电动牙刷可以退换吗|东西买了可以退换吗|发现买错了可以退货吗|买了发现型号不对可以退货吗
米家电动牙刷充满一次电耗时多久|大概需要半小时|充满一次要多久|充电速度怎么样|能说一下米家电动牙刷的充电速度吗|米家电动牙刷的充电速度怎么样|米家电动牙刷的充电速度快吗
你好我想问一下米家电动牙刷|好的，您问。|你好我想问一下米家电动牙刷的相关情况|在吗？我想问一下米家电动牙刷|在吗？我想问一下米家电动牙刷的相关情况|在吗？你们家的米家电动牙刷怎么样|你们家的米家电动牙刷怎么样
米家电动牙刷有噪声吗|有一定的噪声，但是比较低|米家电动牙刷吵吗|电动牙刷是不是很吵|电动牙刷工作时吵吗|牙刷的工作音量大吗|牙刷刷牙时工作音量大吗
米家电动牙刷清理能力如何|很好的，要比普通牙刷好得多|米家电动牙刷能清理干净牙齿吗|米家电动牙刷清理能力强吗|米家电动牙刷清理能力厉害吗|米家电动牙刷的刷牙能力怎么样|米家电动牙刷对牙齿好吗
有几款米家电动牙刷|总共有五款|米家电动牙刷总共有几款呢|米家电动牙刷有几种|总共有多少种米家电动牙刷|可以问一下米家电动牙刷的种类吗|米家电动牙刷分几种啊
米家电动牙刷用起来难度大吗|使用非常简单|米家电动牙刷操作麻烦吗|米家电动牙刷使用难度怎么样|米家电动牙刷操作简单吗|米家电动牙刷的使用简便吗|米家电动牙刷操作麻不麻烦
米家电动牙刷外观好看吗|外观大气简约，您可以在官网查看想要购买类型的示意图哦|米家电动牙刷看起来怎么样|米家电动牙刷外观如何|米家电动牙刷美不美观|米家电动牙刷好看吗|米家电动牙刷好不好看
米家电动牙刷可以自己选择配色吗|这个可以问一下官网的在线服务人员哦|可以自己选择米家电动牙刷的配色吗|米家电动牙刷的配色可以自己选吗|能不能自主选择米家电动牙刷的配色|米家电动牙刷的配色可以自己DIY吗|米家电动牙刷有没有不同的配色可以自己选择呢
米家电动牙刷好用吗|非常好用，使用者体验非常棒|米家电动牙刷用起来爽吗|米家电动牙刷用起来方便吗|米家电动牙刷使用体验如何|米家电动牙刷好使吗|米家电动牙刷用起来怎么样
米家电动牙刷使用寿命长吗|最高可使用高达1000次哦|米家电动牙刷可以用多少次|米家电动牙刷可以用多久|米家电动牙刷可以用多长时间|米家电动牙刷使用寿命有多长|米家电动牙刷大概可以用多长时间
米家电动牙刷具有配套的使用说明书吗|有的，和货物本身一起寄送过来的哦|买米家电动牙刷送使用说明书吗|有米家电动牙刷的使用说明书吗|米家电动牙刷的使用说明书会一起送吗|米家电动牙刷的使用说明书会一起寄过来吗|米家电动牙刷有使用说明书吗
米家电动牙刷配送范围是哪里|这个具体信息可以在官网的配送城市说明里查看~|米家电动牙刷送得到我家吗|米家电动牙刷可以送到哪|米家电动牙刷购配送范围|米家电动牙刷网购可以送哪|米家电动牙刷配送范围多大
米家电动牙刷用户评价咋样|好评如潮啊，可以去官网看下哦|米家电动牙刷用户评价如何|米家电动牙刷好评多吗|米家电动牙刷用户体验咋样|米家电动牙刷好评的人多吗|米家电动牙刷好评率高吗
米家电动牙刷有货吗|您好，您可以在在线商城查看相关信息|米家电动牙刷现在有货吗|我如何知道米家电动牙刷现在是否有货|米家电动牙刷现在有库存吗|能告诉我一下米家电动牙刷现在有货吗|我想了解一下米家电动牙刷现在是否有货
充电要用专门的适配器吗|您好，一般的type C接口即可|充电要用专门的充电器吗|米家电动牙刷充电要用专门的充电器吗|米家电动牙刷充电要用专门的接口吗|充电器要专门购买吗|充电器是特制的吗
米家电动牙刷能更换吗|您好，这件商品支持15天免费换货|米家电动牙刷的换货服务是怎样的|若是对米家电动牙刷不满意，能更换吗|米家电动牙刷能更换吗|我能更换不满意的米家电动牙刷吗|米家电动牙刷的换货政策是怎样的
米家电动牙刷如何清洗|您好，该产品支持直接用水清洗|米家电动牙刷怎么清洁|我怎么清洗我的米家电动牙刷|清洗方法是什么|米家电动牙刷如何正确的保养|米家电动牙刷怎样清洗
米家感应夜灯有优惠吗|抱歉，目前没有优惠哦，请后续关注。|米家感应夜灯有优惠吗|米家感应夜灯现在有啥优惠没|米家感应夜灯能优惠吗|米家感应夜灯有优惠活动吗|米家感应夜灯现在有优惠活动吗
米家感应夜灯多少天之内可以退货|15天无人为损坏，可以包退的|支持退货吗|如果有质量问题能退货吗|买回来多久可以退货|你们可以退货吗|如果不满意可以退货吗
米家感应夜灯多少天之内可以收到货|1-3天内即可收到货，请耐心等待|多久收货|什么时候可以拿到货|多久可以寄到|最快啥时候可以寄到|最快多久收货
米家感应夜灯还需要抢购吗|不需要的，您可以直接购买|米家感应夜灯现在可以买吗|米家感应夜灯有现货吗|米家感应夜灯能不能马上买|米家感应夜灯现在买得到吗|米家感应夜灯官网要抢购吗
米家感应夜灯今天买了，啥时候可以发货|我们会尽快安排，24小时内即可发货|啥时候发货啊|今天可以发货吗|今天可以寄吗|最快啥时候可以收到|今天能发货吗
米家感应夜灯一次充电可以使用多久|大约12小时|单次充电可以用多久|充一次电可以用多久|充一次电可以用多长时间|单次充电可以使用多长时间|用多长时间就没电了
米家感应夜灯包邮吗|购物满150才可以包邮|买够多少钱才可以免邮费|米家感应夜灯是包邮的吗|米家感应夜灯还需要付邮费吗|购物满多少钱可以不用付邮费|这个产品包邮吗
米家感应夜灯可以退货吗|可以的，七天内无理由退货|对米家感应夜灯不满意可以退货吗|米家感应夜灯可以退换吗|东西买了可以退换吗|发现买错了可以退货吗|买了发现型号不对可以退货吗
米家感应夜灯充满一次电耗时多久|大概需要半小时|充满一次要多久|充电速度怎么样|能说一下米家感应夜灯的充电速度吗|米家感应夜灯的充电速度怎么样|米家感应夜灯的充电速度快吗
你好我想问一下米家感应夜灯|好的，您问。|你好我想问一下米家感应夜灯的相关情况|在吗？我想问一下米家感应夜灯|在吗？我想问一下米家感应夜灯的相关情况|在吗？你们家的米家感应夜灯怎么样|你们家的米家感应夜灯怎么样
谢谢你的回复，再见|好的，感谢咨询，欢迎下次光临|谢谢|再见|多谢|谢谢你的服务|多谢，拜拜
你好，在吗|您好，有什么可以帮助您|你好啊|在吗|您好|您好，有些问题想请教一下|你好，在忙吗
有几款米家感应夜灯|总共有五款|米家感应夜灯总共有几款呢|米家感应夜灯有几种|总共有多少种米家感应夜灯|可以问一下米家感应夜灯的种类吗|米家感应夜灯分几种啊
杭州有小米之家吗|有的，您可以百度查下地址|杭州小米之家在哪里|小米之家杭州有实体店吗|杭州的小米之家地址在哪|杭州小米之家开了吗|我想去杭州小米之家，有实体店吗
米家感应夜灯外观好看吗|外观大气简约，您可以在官网查看想要购买类型的示意图哦|米家感应夜灯看起来怎么样|米家感应夜灯外观如何|米家感应夜灯美不美观|米家感应夜灯好看吗|米家感应夜灯好不好看
米家感应夜灯可以自己选择配色吗|这个可以问一下官网的在线服务人员哦|可以自己选择米家感应夜灯的配色吗|米家感应夜灯的配色可以自己选吗|能不能自主选择米家感应夜灯的配色|米家感应夜灯的配色可以自己DIY吗|米家感应夜灯有没有不同的配色可以自己选择呢
米家感应夜灯好用吗|非常好用，使用者体验非常棒|米家感应夜灯用起来爽吗|米家感应夜灯用起来方便吗|米家感应夜灯使用体验如何|米家感应夜灯好使吗|米家感应夜灯用起来怎么样
米家感应夜灯使用寿命长吗|最高可使用高达1000小时哦|米家感应夜灯可以用多少次|米家感应夜灯可以用多久|米家感应夜灯可以用多长时间|米家感应夜灯使用寿命有多长|米家感应夜灯大概可以用多长时间
米家感应夜灯具有配套的使用说明书吗|有的，和货物本身一起寄送过来的哦|买米家感应夜灯送使用说明书吗|有米家感应夜灯的使用说明书吗|米家感应夜灯的使用说明书会一起送吗|米家感应夜灯的使用说明书会一起寄过来吗|米家感应夜灯有使用说明书吗
米家感应夜灯刷配送范围是哪里|这个具体信息可以在官网的配送城市说明里查看~|米家感应夜灯送得到我家吗|米家感应夜灯可以送到哪|米家感应夜灯购配送范围|米家感应夜灯网购可以送哪|米家感应夜灯配送范围多大
米家感应夜灯用户评价咋样|好评如潮啊，可以去官网看下哦|米家感应夜灯用户评价如何|米家感应夜灯好评多吗|米家感应夜灯用户体验咋样|米家感应夜灯好评的人多吗|米家感应夜灯好评率高吗
米家感应夜灯有货吗|您好，您可以在在线商城查看相关信息|米家感应夜灯现在有货吗|我如何知道米家感应夜灯现在是否有货|米家感应夜灯现在有库存吗|能告诉我一下米家感应夜灯现在有货吗|我想了解一下米家感应夜灯现在是否有货
充电要用专门的适配器吗|您好，一般的type C接口即可|充电要用专门的充电器吗|米家感应夜灯充电要用专门的充电器吗|米家感应夜灯充电要用专门的接口吗|充电器要专门购买吗|充电器是特制的吗
米家感应夜灯能更换吗|您好，这件商品支持15天免费换货|米家感应夜灯的换货服务是怎样的|若是对米家感应夜灯不满意，能更换吗|米家感应夜灯能更换吗|我能更换不满意的米家感应夜灯吗|米家感应夜灯的换货政策是怎样的
米家感应夜灯如何清洗|您好，该产品支持直接用水清洗|米家感应夜灯怎么清洁|我怎么清洗我的米家感应夜灯|清洗方法是什么|米家感应夜灯如何正确的保养|米家感应夜灯怎样清洗
小方智能摄像机有优惠吗|抱歉，目前没有优惠哦，请后续关注。|小方智能摄像机有优惠吗|小方智能摄像机现在有啥优惠没|小方智能摄像机能优惠吗|小方智能摄像机有优惠活动吗|小方智能摄像机现在有优惠活动吗
小方智能摄像机多少天之内可以退货|15天无人为损坏，可以包退的|支持退货吗|如果有质量问题能退货吗|买回来多久可以退货|你们可以退货吗|如果不满意可以退货吗
小方智能摄像机多少天之内可以收到货|1-3天内即可收到货，请耐心等待|多久收货|什么时候可以拿到货|多久可以寄到|最快啥时候可以寄到|最快多久收货
小方智能摄像机还需要抢购吗|不需要的，您可以直接购买|小方智能摄像机现在可以买吗|小方智能摄像机有现货吗|小方智能摄像机能不能马上买|小方智能摄像机现在买得到吗|小方智能摄像机官网要抢购吗
小方智能摄像机今天买了，啥时候可以发货|我们会尽快安排，24小时内即可发货|啥时候发货啊|今天可以发货吗|今天可以寄吗|最快啥时候可以收到|今天能发货吗
小方智能摄像机一次充电可以使用多久|大约12小时|单次充电可以用多久|充一次电可以用多久|充一次电可以用多长时间|单次充电可以使用多长时间|用多长时间就没电了
小方智能摄像机包邮吗|购物满150才可以包邮|买够多少钱才可以免邮费|小方智能摄像机是包邮的吗|小方智能摄像机还需要付邮费吗|购物满多少钱可以不用付邮费|这个产品包邮吗
小方智能摄像机可以退货吗|可以的，七天内无理由退货|对小方智能摄像机不满意可以退货吗|小方智能摄像机可以退换吗|东西买了可以退换吗|发现买错了可以退货吗|买了发现型号不对可以退货吗
小方智能摄像机充满一次电耗时多久|大概需要半小时|充满一次要多久|充电速度怎么样|能说一下小方智能摄像机的充电速度吗|小方智能摄像机的充电速度怎么样|小方智能摄像机的充电速度快吗
你好我想问一下小方智能摄像机|好的，您问。|你好我想问一下小方智能摄像机的相关情况|在吗？我想问一下小方智能摄像机|在吗？我想问一下小方智能摄像机的相关情况|在吗？你们家的小方智能摄像机怎么样|你们家的小方智能摄像机怎么样
米家感应夜灯可以网购吗|可以的，具体可以查看官网的说明哦|可以网购米家感应夜灯吗|可以在网上买米家感应夜灯吗|网上可以买到米家感应夜灯吗|米家感应夜灯网上买可以吗|米家感应夜灯支持网购吗
杭州有小米之家吗|有的，您可以百度查下地址|杭州小米之家在哪里|小米之家杭州有实体店吗|杭州的小米之家地址在哪|杭州小米之家开了吗|我想去杭州小米之家，有实体店吗
有几款小方智能摄像机|总共有五款|小方智能摄像机总共有几款呢|小方智能摄像机有几种|总共有多少种小方智能摄像机|可以问一下小方智能摄像机的种类吗|小方智能摄像机分几种啊
您好，我想了解一下小方智能摄像机|您好，关于小方智能摄像机，有什么想问的呢|能给我介绍一下小方智能摄像机吗|我想了解一下小方智能摄像机|关于小方智能摄像机我有一些问题|您好，我想咨询一下关于小方智能摄像机的问题|我想询问一下小方智能摄像机的信息
小方智能摄像机外观好看吗|外观大气简约，您可以在官网查看想要购买类型的示意图哦|小方智能摄像机看起来怎么样|小方智能摄像机外观如何|小方智能摄像机美不美观|小方智能摄像机好看吗|小方智能摄像机好不好看
小方智能摄像机可以自己选择配色吗|这个可以问一下官网的在线服务人员哦|可以自己选择小方智能摄像机的配色吗|小方智能摄像机的配色可以自己选吗|能不能自主选择小方智能摄像机的配色|小方智能摄像机的配色可以自己DIY吗|小方智能摄像机有没有不同的配色可以自己选择呢
小方智能摄像机好用吗|非常好用，使用者体验非常棒|小方智能摄像机用起来爽吗|小方智能摄像机用起来方便吗|小方智能摄像机使用体验如何|小方智能摄像机好使吗|小方智能摄像机用起来怎么样
小方智能摄像机使用寿命长吗|最高可使用高达1000小时哦|小方智能摄像机可以用多少次|小方智能摄像机可以用多久|小方智能摄像机可以用多长时间|小方智能摄像机使用寿命有多长|小方智能摄像机大概可以用多长时间
小方智能摄像机具有配套的使用说明书吗|有的，和货物本身一起寄送过来的哦|买小方智能摄像机送使用说明书吗|有小方智能摄像机的使用说明书吗|小方智能摄像机的使用说明书会一起送吗|小方智能摄像机的使用说明书会一起寄过来吗|小方智能摄像机有使用说明书吗
小方智能摄像机刷配送范围是哪里|这个具体信息可以在官网的配送城市说明里查看~|小方智能摄像机送得到我家吗|小方智能摄像机可以送到哪|小方智能摄像机购配送范围|小方智能摄像机网购可以送哪|小方智能摄像机配送范围多大
小方智能摄像机用户评价咋样|好评如潮啊，可以去官网看下哦|小方智能摄像机用户评价如何|小方智能摄像机好评多吗|小方智能摄像机用户体验咋样|小方智能摄像机好评的人多吗|小方智能摄像机好评率高吗
小方智能摄像机有货吗|您好，您可以在在线商城查看相关信息|小方智能摄像机现在有货吗|我如何知道小方智能摄像机现在是否有货|小方智能摄像机现在有库存吗|能告诉我一下小方智能摄像机现在有货吗|我想了解一下小方智能摄像机现在是否有货
充电要用专门的适配器吗|您好，一般的type C接口即可|充电要用专门的充电器吗|小方智能摄像机充电要用专门的充电器吗|小方智能摄像机充电要用专门的接口吗|充电器要专门购买吗|充电器是特制的吗
小方智能摄像机能更换吗|您好，这件商品支持15天免费换货|小方智能摄像机的换货服务是怎样的|若是对小方智能摄像机不满意，能更换吗|小方智能摄像机能更换吗|我能更换不满意的小方智能摄像机吗|小方智能摄像机的换货政策是怎样的
小方智能摄像机如何清洗|您好，该产品支持直接用水清洗|小方智能摄像机怎么清洁|我怎么清洗我的小方智能摄像机|清洗方法是什么|小方智能摄像机如何正确的保养|小方智能摄像机怎样清洗
运动手表有优惠吗|抱歉，目前没有优惠哦，请后续关注。|运动手表有优惠吗|运动手表现在有啥优惠没|运动手表能优惠吗|运动手表有优惠活动吗|运动手表现在有优惠活动吗
运动手表多少天之内可以退货|15天无人为损坏，可以包退的|支持退货吗|如果有质量问题能退货吗|买回来多久可以退货|你们可以退货吗|如果不满意可以退货吗
运动手表多少天之内可以收到货|1-3天内即可收到货，请耐心等待|多久收货|什么时候可以拿到货|多久可以寄到|最快啥时候可以寄到|最快多久收货
运动手表还需要抢购吗|不需要的，您可以直接购买|运动手表现在可以买吗|运动手表有现货吗|运动手表能不能马上买|运动手表现在买得到吗|运动手表官网要抢购吗
运动手表今天买了，啥时候可以发货|我们会尽快安排，24小时内即可发货|啥时候发货啊|今天可以发货吗|今天可以寄吗|最快啥时候可以收到|今天能发货吗
运动手表一次充电可以使用多久|大约12小时|单次充电可以用多久|充一次电可以用多久|充一次电可以用多长时间|单次充电可以使用多长时间|用多长时间就没电了
运动手表包邮吗|购物满150才可以包邮|买够多少钱才可以免邮费|运动手表是包邮的吗|运动手表还需要付邮费吗|购物满多少钱可以不用付邮费|这个产品包邮吗
运动手表可以退货吗|可以的，七天内无理由退货|对运动手表不满意可以退货吗|运动手表可以退换吗|东西买了可以退换吗|发现买错了可以退货吗|买了发现型号不对可以退货吗
运动手表充满一次电耗时多久|大概需要半小时|充满一次要多久|充电速度怎么样|能说一下运动手表的充电速度吗|运动手表的充电速度怎么样|运动手表的充电速度快吗
你好我想问一下运动手表|好的，您问。|你好我想问一下运动手表的相关情况|在吗？我想问一下运动手表|在吗？我想问一下运动手表的相关情况|在吗？你们家的运动手表怎么样|你们家的运动手表怎么样
运动手表可以网购吗|可以的，具体可以查看官网的说明哦|可以网购运动手表吗|可以在网上买运动手表吗|网上可以买到运动手表吗|运动手表网上买可以吗|运动手表支持网购吗
有几款运动手表|总共有五款|运动手表总共有几款呢|运动手表有几种|总共有多少种运动手表|可以问一下运动手表的种类吗|运动手表分几种啊
谢谢你的回复，再见|好的，感谢咨询，欢迎下次光临|谢谢|再见|多谢|谢谢你的服务|多谢，拜拜
运动手表外观好看吗|外观大气简约，您可以在官网查看想要购买类型的示意图哦|运动手表看起来怎么样|运动手表外观如何|运动手表美不美观|运动手表好看吗|运动手表好不好看
运动手表可以自己选择配色吗|这个可以问一下官网的在线服务人员哦|可以自己选择运动手表的配色吗|运动手表的配色可以自己选吗|能不能自主选择运动手表的配色|运动手表的配色可以自己DIY吗|运动手表有没有不同的配色可以自己选择呢
运动手表好用吗|非常好用，使用者体验非常棒|运动手表用起来爽吗|运动手表用起来方便吗|运动手表使用体验如何|运动手表好使吗|运动手表用起来怎么样
运动手表使用寿命长吗|最高可使用高达1000小时哦|运动手表可以用多少次|运动手表可以用多久|运动手表可以用多长时间|运动手表使用寿命有多长|运动手表大概可以用多长时间
运动手表具有配套的使用说明书吗|有的，和货物本身一起寄送过来的哦|买运动手表送使用说明书吗|有运动手表的使用说明书吗|运动手表的使用说明书会一起送吗|运动手表的使用说明书会一起寄过来吗|运动手表有使用说明书吗
运动手表刷配送范围是哪里|这个具体信息可以在官网的配送城市说明里查看~|运动手表送得到我家吗|运动手表可以送到哪|运动手表购配送范围|运动手表网购可以送哪|运动手表配送范围多大
运动手表用户评价咋样|好评如潮啊，可以去官网看下哦|运动手表用户评价如何|运动手表好评多吗|运动手表用户体验咋样|运动手表好评的人多吗|运动手表好评率高吗
运动手表有货吗|您好，您可以在在线商城查看相关信息|运动手表现在有货吗|我如何知道运动手表现在是否有货|运动手表现在有库存吗|能告诉我一下运动手表现在有货吗|我想了解一下运动手表现在是否有货
充电要用专门的适配器吗|您好，一般的type C接口即可|充电要用专门的充电器吗|运动手表充电要用专门的充电器吗|运动手表充电要用专门的接口吗|充电器要专门购买吗|充电器是特制的吗
运动手表能更换吗|您好，这件商品支持15天免费换货|运动手表的换货服务是怎样的|若是对运动手表不满意，能更换吗|运动手表能更换吗|我能更换不满意的运动手表吗|运动手表的换货政策是怎样的
运动手表如何清洗|您好，该产品支持直接用水清洗|运动手表怎么清洁|我怎么清洗我的运动手表|清洗方法是什么|运动手表如何正确的保养|运动手表怎样清洗
智能家庭组合有优惠吗|抱歉，目前没有优惠哦，请后续关注。|智能家庭组合有优惠吗|智能家庭组合现在有啥优惠没|智能家庭组合能优惠吗|智能家庭组合有优惠活动吗|智能家庭组合现在有优惠活动吗
智能家庭组合多少天之内可以退货|15天无人为损坏，可以包退的|支持退货吗|如果有质量问题能退货吗|买回来多久可以退货|你们可以退货吗|如果不满意可以退货吗
智能家庭组合多少天之内可以收到货|1-3天内即可收到货，请耐心等待|多久收货|什么时候可以拿到货|多久可以寄到|最快啥时候可以寄到|最快多久收货
智能家庭组合还需要抢购吗|不需要的，您可以直接购买|智能家庭组合现在可以买吗|智能家庭组合有现货吗|智能家庭组合能不能马上买|智能家庭组合现在买得到吗|智能家庭组合官网要抢购吗
智能家庭组合今天买了，啥时候可以发货|我们会尽快安排，24小时内即可发货|啥时候发货啊|今天可以发货吗|今天可以寄吗|最快啥时候可以收到|今天能发货吗
智能家庭组合一次充电可以使用多久|大约12小时|单次充电可以用多久|充一次电可以用多久|充一次电可以用多长时间|单次充电可以使用多长时间|用多长时间就没电了
智能家庭组合包邮吗|购物满150才可以包邮|买够多少钱才可以免邮费|智能家庭组合是包邮的吗|智能家庭组合还需要付邮费吗|购物满多少钱可以不用付邮费|这个产品包邮吗
智能家庭组合可以退货吗|可以的，七天内无理由退货|对智能家庭组合不满意可以退货吗|智能家庭组合可以退换吗|东西买了可以退换吗|发现买错了可以退货吗|买了发现型号不对可以退货吗
智能家庭组合充满一次电耗时多久|大概需要半小时|充满一次要多久|充电速度怎么样|能说一下智能家庭组合的充电速度吗|智能家庭组合的充电速度怎么样|智能家庭组合的充电速度快吗
你好我想问一下智能家庭组合|好的，您问。|你好我想问一下智能家庭组合的相关情况|在吗？我想问一下智能家庭组合|在吗？我想问一下智能家庭组合的相关情况|在吗？你们家的智能家庭组合怎么样|你们家的智能家庭组合怎么样
智能家庭组合可以网购吗|可以的，具体可以查看官网的说明哦|可以网购智能家庭组合吗|可以在网上买智能家庭组合吗|网上可以买到智能家庭组合吗|智能家庭组合网上买可以吗|智能家庭组合支持网购吗
您好，我想了解一下智能家庭组合|您好，关于智能家庭组合，有什么想问的呢|能给我介绍一下智能家庭组合吗|我想了解一下智能家庭组合|关于智能家庭组合我有一些问题|您好，我想咨询一下关于智能家庭组合的问题|我想询问一下智能家庭组合的信息
您好，我想了解一下智能家庭组合|您好，关于智能家庭组合，有什么想问的呢|能给我介绍一下智能家庭组合吗|我想了解一下智能家庭组合|关于智能家庭组合我有一些问题|您好，我想咨询一下关于智能家庭组合的问题|我想询问一下智能家庭组合的信息
有几款智能家庭组合|总共有五款|智能家庭组合总共有几款呢|智能家庭组合有几种|总共有多少种智能家庭组合|可以问一下智能家庭组合的种类吗|智能家庭组合分几种啊
杭州有小米之家吗|有的，您可以百度查下地址|杭州小米之家在哪里|小米之家杭州有实体店吗|杭州的小米之家地址在哪|杭州小米之家开了吗|我想去杭州小米之家，有实体店吗
智能家庭组合外观好看吗|外观大气简约，您可以在官网查看想要购买类型的示意图哦|智能家庭组合看起来怎么样|智能家庭组合外观如何|智能家庭组合美不美观|智能家庭组合好看吗|智能家庭组合好不好看
智能家庭组合可以自己选择配色吗|这个可以问一下官网的在线服务人员哦|可以自己选择智能家庭组合的配色吗|智能家庭组合的配色可以自己选吗|能不能自主选择智能家庭组合的配色|智能家庭组合的配色可以自己DIY吗|智能家庭组合有没有不同的配色可以自己选择呢
智能家庭组合好用吗|非常好用，使用者体验非常棒|智能家庭组合用起来爽吗|智能家庭组合用起来方便吗|智能家庭组合使用体验如何|智能家庭组合好使吗|智能家庭组合用起来怎么样
智能家庭组合使用寿命长吗|最高可使用高达1000小时哦|智能家庭组合可以用多少次|智能家庭组合可以用多久|智能家庭组合可以用多长时间|智能家庭组合使用寿命有多长|智能家庭组合大概可以用多长时间
智能家庭组合具有配套的使用说明书吗|有的，和货物本身一起寄送过来的哦|买智能家庭组合送使用说明书吗|有智能家庭组合的使用说明书吗|智能家庭组合的使用说明书会一起送吗|智能家庭组合的使用说明书会一起寄过来吗|智能家庭组合有使用说明书吗
智能家庭组合刷配送范围是哪里|这个具体信息可以在官网的配送城市说明里查看~|智能家庭组合送得到我家吗|智能家庭组合可以送到哪|智能家庭组合购配送范围|智能家庭组合网购可以送哪|智能家庭组合配送范围多大
智能家庭组合用户评价咋样|好评如潮啊，可以去官网看下哦|智能家庭组合用户评价如何|智能家庭组合好评多吗|智能家庭组合用户体验咋样|智能家庭组合好评的人多吗|智能家庭组合好评率高吗
智能家庭组合有货吗|您好，您可以在在线商城查看相关信息|智能家庭组合现在有货吗|我如何知道智能家庭组合现在是否有货|智能家庭组合现在有库存吗|能告诉我一下智能家庭组合现在有货吗|我想了解一下智能家庭组合现在是否有货
充电要用专门的适配器吗|您好，一般的type C接口即可|充电要用专门的充电器吗|智能家庭组合充电要用专门的充电器吗|智能家庭组合充电要用专门的接口吗|充电器要专门购买吗|充电器是特制的吗
智能家庭组合能更换吗|您好，这件商品支持15天免费换货|智能家庭组合的换货服务是怎样的|若是对智能家庭组合不满意，能更换吗|智能家庭组合能更换吗|我能更换不满意的智能家庭组合吗|智能家庭组合的换货政策是怎样的
智能家庭组合如何清洗|您好，该产品支持直接用水清洗|智能家庭组合怎么清洁|我怎么清洗我的智能家庭组合|清洗方法是什么|智能家庭组合如何正确的保养|智能家庭组合怎样清洗
床头灯有优惠吗|抱歉，目前没有优惠哦，请后续关注。|床头灯有优惠吗|床头灯现在有啥优惠没|床头灯能优惠吗|床头灯有优惠活动吗|床头灯现在有优惠活动吗
床头灯多少天之内可以退货|15天无人为损坏，可以包退的|支持退货吗|如果有质量问题能退货吗|买回来多久可以退货|你们可以退货吗|如果不满意可以退货吗
床头灯多少天之内可以收到货|1-3天内即可收到货，请耐心等待|多久收货|什么时候可以拿到货|多久可以寄到|最快啥时候可以寄到|最快多久收货
床头灯还需要抢购吗|不需要的，您可以直接购买|床头灯现在可以买吗|床头灯有现货吗|床头灯能不能马上买|床头灯现在买得到吗|床头灯官网要抢购吗
床头灯今天买了，啥时候可以发货|我们会尽快安排，24小时内即可发货|啥时候发货啊|今天可以发货吗|今天可以寄吗|最快啥时候可以收到|今天能发货吗
床头灯一次充电可以使用多久|大约12小时|单次充电可以用多久|充一次电可以用多久|充一次电可以用多长时间|单次充电可以使用多长时间|用多长时间就没电了
床头灯包邮吗|购物满150才可以包邮|买够多少钱才可以免邮费|床头灯是包邮的吗|床头灯还需要付邮费吗|购物满多少钱可以不用付邮费|这个产品包邮吗
床头灯可以退货吗|可以的，七天内无理由退货|对床头灯不满意可以退货吗|床头灯可以退换吗|东西买了可以退换吗|发现买错了可以退货吗|买了发现型号不对可以退货吗
床头灯充满一次电耗时多久|大概需要半小时|充满一次要多久|充电速度怎么样|能说一下床头灯的充电速度吗|床头灯的充电速度怎么样|床头灯的充电速度快吗
你好我想问一下床头灯|好的，您问。|你好我想问一下床头灯的相关情况|在吗？我想问一下床头灯|在吗？我想问一下床头灯的相关情况|在吗？你们家的床头灯怎么样|你们家的床头灯怎么样
谢谢你的回复，再见|好的，感谢咨询，欢迎下次光临|谢谢|再见|多谢|谢谢你的服务|多谢，拜拜
床头灯可以网购吗|可以的，具体可以查看官网的说明哦|可以网购床头灯吗|可以在网上买床头灯吗|网上可以买到床头灯吗|床头灯网上买可以吗|床头灯支持网购吗
有几款床头灯|总共有五款|床头灯总共有几款呢|床头灯有几种|总共有多少种床头灯|可以问一下床头灯的种类吗|床头灯分几种啊
您好，我想了解一下床头灯|您好，关于床头灯，有什么想问的呢|能给我介绍一下床头灯吗|我想了解一下床头灯|关于床头灯我有一些问题|您好，我想咨询一下关于床头灯的问题|我想询问一下床头灯的信息
床头灯外观好看吗|外观大气简约，您可以在官网查看想要购买类型的示意图哦|床头灯看起来怎么样|床头灯外观如何|床头灯美不美观|床头灯好看吗|床头灯好不好看
床头灯可以自己选择配色吗|这个可以问一下官网的在线服务人员哦|可以自己选择床头灯的配色吗|床头灯的配色可以自己选吗|能不能自主选择床头灯的配色|床头灯的配色可以自己DIY吗|床头灯有没有不同的配色可以自己选择呢
床头灯好用吗|非常好用，使用者体验非常棒|床头灯用起来爽吗|床头灯用起来方便吗|床头灯使用体验如何|床头灯好使吗|床头灯用起来怎么样
床头灯使用寿命长吗|最高可使用高达1000小时哦|床头灯可以用多少次|床头灯可以用多久|床头灯可以用多长时间|床头灯使用寿命有多长|床头灯大概可以用多长时间
床头灯具有配套的使用说明书吗|有的，和货物本身一起寄送过来的哦|买床头灯送使用说明书吗|有床头灯的使用说明书吗|床头灯的使用说明书会一起送吗|床头灯的使用说明书会一起寄过来吗|床头灯有使用说明书吗
床头灯刷配送范围是哪里|这个具体信息可以在官网的配送城市说明里查看~|床头灯送得到我家吗|床头灯可以送到哪|床头灯购配送范围|床头灯网购可以送哪|床头灯配送范围多大
床头灯用户评价咋样|好评如潮啊，可以去官网看下哦|床头灯用户评价如何|床头灯好评多吗|床头灯用户体验咋样|床头灯好评的人多吗|床头灯好评率高吗
床头灯有货吗|您好，您可以在在线商城查看相关信息|床头灯现在有货吗|我如何知道床头灯现在是否有货|床头灯现在有库存吗|能告诉我一下床头灯现在有货吗|我想了解一下床头灯现在是否有货
充电要用专门的适配器吗|您好，一般的type C接口即可|充电要用专门的充电器吗|床头灯充电要用专门的充电器吗|床头灯充电要用专门的接口吗|充电器要专门购买吗|充电器是特制的吗
床头灯能更换吗|您好，这件商品支持15天免费换货|床头灯的换货服务是怎样的|若是对床头灯不满意，能更换吗|床头灯能更换吗|我能更换不满意的床头灯吗|床头灯的换货政策是怎样的
床头灯如何清洗|您好，该产品支持直接用水清洗|床头灯怎么清洁|我怎么清洗我的床头灯|清洗方法是什么|床头灯如何正确的保养|床头灯怎样清洗
大方智能摄像机有优惠吗|抱歉，目前没有优惠哦，请后续关注。|大方智能摄像机有优惠吗|大方智能摄像机现在有啥优惠没|大方智能摄像机能优惠吗|大方智能摄像机有优惠活动吗|大方智能摄像机现在有优惠活动吗
大方智能摄像机多少天之内可以退货|15天无人为损坏，可以包退的|支持退货吗|如果有质量问题能退货吗|买回来多久可以退货|你们可以退货吗|如果不满意可以退货吗
大方智能摄像机多少天之内可以收到货|1-3天内即可收到货，请耐心等待|多久收货|什么时候可以拿到货|多久可以寄到|最快啥时候可以寄到|最快多久收货
大方智能摄像机还需要抢购吗|不需要的，您可以直接购买|大方智能摄像机现在可以买吗|大方智能摄像机有现货吗|大方智能摄像机能不能马上买|大方智能摄像机现在买得到吗|大方智能摄像机官网要抢购吗
大方智能摄像机今天买了，啥时候可以发货|我们会尽快安排，24小时内即可发货|啥时候发货啊|今天可以发货吗|今天可以寄吗|最快啥时候可以收到|今天能发货吗
大方智能摄像机一次充电可以使用多久|大约12小时|单次充电可以用多久|充一次电可以用多久|充一次电可以用多长时间|单次充电可以使用多长时间|用多长时间就没电了
大方智能摄像机包邮吗|购物满150才可以包邮|买够多少钱才可以免邮费|大方智能摄像机是包邮的吗|大方智能摄像机还需要付邮费吗|购物满多少钱可以不用付邮费|这个产品包邮吗
大方智能摄像机可以退货吗|可以的，七天内无理由退货|对大方智能摄像机不满意可以退货吗|大方智能摄像机可以退换吗|东西买了可以退换吗|发现买错了可以退货吗|买了发现型号不对可以退货吗
大方智能摄像机充满一次电耗时多久|大概需要半小时|充满一次要多久|充电速度怎么样|能说一下大方智能摄像机的充电速度吗|大方智能摄像机的充电速度怎么样|大方智能摄像机的充电速度快吗
你好我想问一下大方智能摄像机|好的，您问。|你好我想问一下大方智能摄像机的相关情况|在吗？我想问一下大方智能摄像机|在吗？我想问一下大方智能摄像机的相关情况|在吗？你们家的大方智能摄像机怎么样|你们家的大方智能摄像机怎么样
小方智能摄像机可以网购吗|可以的，具体可以查看官网的说明哦|可以网购小方智能摄像机吗|可以在网上买小方智能摄像机吗|网上可以买到小方智能摄像机吗|小方智能摄像机网上买可以吗|小方智能摄像机支持网购吗
大方智能摄像机可以网购吗|可以的，具体可以查看官网的说明哦|可以网购大方智能摄像机吗|可以在网上买大方智能摄像机吗|网上可以买到大方智能摄像机吗|大方智能摄像机网上买可以吗|大方智能摄像机支持网购吗
有几款大方智能摄像机|总共有五款|大方智能摄像机总共有几款呢|大方智能摄像机有几种|总共有多少种大方智能摄像机|可以问一下大方智能摄像机的种类吗|大方智能摄像机分几种啊
谢谢你的回复，再见|好的，感谢咨询，欢迎下次光临|谢谢|再见|多谢|谢谢你的服务|多谢，拜拜
大方智能摄像机外观好看吗|外观大气简约，您可以在官网查看想要购买类型的示意图哦|大方智能摄像机看起来怎么样|大方智能摄像机外观如何|大方智能摄像机美不美观|大方智能摄像机好看吗|大方智能摄像机好不好看
大方智能摄像机可以自己选择配色吗|这个可以问一下官网的在线服务人员哦|可以自己选择大方智能摄像机的配色吗|大方智能摄像机的配色可以自己选吗|能不能自主选择大方智能摄像机的配色|大方智能摄像机的配色可以自己DIY吗|大方智能摄像机有没有不同的配色可以自己选择呢
大方智能摄像机好用吗|非常好用，使用者体验非常棒|大方智能摄像机用起来爽吗|大方智能摄像机用起来方便吗|大方智能摄像机使用体验如何|大方智能摄像机好使吗|大方智能摄像机用起来怎么样
大方智能摄像机使用寿命长吗|最高可使用高达1000小时哦|大方智能摄像机可以用多少次|大方智能摄像机可以用多久|大方智能摄像机可以用多长时间|大方智能摄像机使用寿命有多长|大方智能摄像机大概可以用多长时间
大方智能摄像机具有配套的使用说明书吗|有的，和货物本身一起寄送过来的哦|买大方智能摄像机送使用说明书吗|有大方智能摄像机的使用说明书吗|大方智能摄像机的使用说明书会一起送吗|大方智能摄像机的使用说明书会一起寄过来吗|大方智能摄像机有使用说明书吗
大方智能摄像机刷配送范围是哪里|这个具体信息可以在官网的配送城市说明里查看~|大方智能摄像机送得到我家吗|大方智能摄像机可以送到哪|大方智能摄像机购配送范围|大方智能摄像机网购可以送哪|大方智能摄像机配送范围多大
大方智能摄像机用户评价咋样|好评如潮啊，可以去官网看下哦|大方智能摄像机用户评价如何|大方智能摄像机好评多吗|大方智能摄像机用户体验咋样|大方智能摄像机好评的人多吗|大方智能摄像机好评率高吗
大方智能摄像机有货吗|您好，您可以在在线商城查看相关信息|大方智能摄像机现在有货吗|我如何知道大方智能摄像机现在是否有货|大方智能摄像机现在有库存吗|能告诉我一下大方智能摄像机现在有货吗|我想了解一下大方智能摄像机现在是否有货
充电要用专门的适配器吗|您好，一般的type C接口即可|充电要用专门的充电器吗|大方智能摄像机充电要用专门的充电器吗|大方智能摄像机充电要用专门的接口吗|充电器要专门购买吗|充电器是特制的吗
大方智能摄像机能更换吗|您好，这件商品支持15天免费换货|大方智能摄像机的换货服务是怎样的|若是对大方智能摄像机不满意，能更换吗|大方智能摄像机能更换吗|我能更换不满意的大方智能摄像机吗|大方智能摄像机的换货政策是怎样的
大方智能摄像机如何清洗|您好，该产品支持直接用水清洗|大方智能摄像机怎么清洁|我怎么清洗我的大方智能摄像机|清洗方法是什么|大方智能摄像机如何正确的保养|大方智能摄像机怎样清洗
运动手表具有配套的使用说明书吗|有的，和货物本身一起寄送过来的哦|买运动手表送使用说明书吗|有运动手表的使用说明书吗|运动手表的使用说明书会一起送吗|运动手表的使用说明书会一起寄过来吗|运动手表有使用说明书吗
运动手表刷配送范围是哪里|这个具体信息可以在官网的配送城市说明里查看~|运动手表送得到我家吗|运动手表可以送到哪|运动手表购配送范围|运动手表网购可以送哪|运动手表配送范围多大
运动手表用户评价咋样|好评如潮啊，可以去官网看下哦|运动手表用户评价如何|运动手表好评多吗|运动手表用户体验咋样|运动手表好评的人多吗|运动手表好评率高吗
运动手表有货吗|您好，您可以在在线商城查看相关信息|运动手表现在有货吗|我如何知道运动手表现在是否有货|运动手表现在有库存吗|能告诉我一下运动手表现在有货吗|我想了解一下运动手表现在是否有货
充电要用专门的适配器吗|您好，一般的type C接口即可|充电要用专门的充电器吗|运动手表充电要用专门的充电器吗|运动手表充电要用专门的接口吗|充电器要专门购买吗|充电器是特制的吗
运动手表能更换吗|您好，这件商品支持15天免费换货|运动手表的换货服务是怎样的|若是对运动手表不满意，能更换吗|运动手表能更换吗|我能更换不满意的运动手表吗|运动手表的换货政策是怎样的
运动手表如何清洗|您好，该产品支持直接用水清洗|运动手表怎么清洁|我怎么清洗我的运动手表|清洗方法是什么|运动手表如何正确的保养|运动手表怎样清洗
智能家庭组合有优惠吗|抱歉，目前没有优惠哦，请后续关注。|智能家庭组合有优惠吗|智能家庭组合现在有啥优惠没|智能家庭组合能优惠吗|智能家庭组合有优惠活动吗|智能家庭组合现在有优惠活动吗
智能家庭组合多少天之内可以退货|15天无人为损坏，可以包退的|支持退货吗|如果有质量问题能退货吗|买回来多久可以退货|你们可以退货吗|如果不满意可以退货吗
体脂秤测得准吗|测得很准的，欢迎来店里试用|体脂秤准确度怎么样|体脂秤准吗|体脂秤准确率高吗|体脂秤准不准啊|体脂秤靠谱吗
体脂秤是干嘛用的|这是用来测试您身体中脂肪含量的|体脂秤用途是什么|体脂秤有什么用|体脂秤用来做什么|体脂秤用来干嘛|体脂秤有什么功能
体脂秤质量怎么样|那是相当Ok的|体脂秤质量咋样|体脂秤靠谱吗|体脂秤的屏幕质量怎样|体脂秤显示屏质量怎样|体脂秤显示屏质量靠谱吗
体脂秤有优惠吗|抱歉，目前没有优惠哦，请后续关注。|体脂秤有优惠吗|体脂秤现在有啥优惠没|体脂秤能优惠吗|体脂秤有优惠活动吗|体脂秤现在有优惠活动吗
体脂秤有承重限制吗|5kg-150kg都可以的|体脂秤最大重量多少|体脂秤多重会碎|体脂秤最大承重多少|体脂秤有最大重量吗|体脂秤最大可以称多重
体脂秤尺寸多少|体脂秤是300*300*20mm|体脂秤多大|体脂秤长宽高多少|体脂秤面积多大|体脂秤占地方吗|体脂秤会不会很大
体脂秤有多重|体脂秤是1.6kg|体脂秤重量多少|体脂秤多少千克|体脂秤多少kg|体脂秤重不重啊|体脂秤质量多少
体脂秤可以退货吗|七天无理由退货哦|体脂秤多久可以退|体脂秤可以无理由退货吗|体脂秤退货是什么样的|体脂秤退货有什么规定吗|体脂秤不喜欢可以退吗
体脂秤保修期多久|保修期为一年，您可以放心使用|体脂秤能保修多久|体脂秤的保修期是多久|我想问下体脂秤能保修多久|体脂秤怎么保修呢|体脂秤保修时间长吗
体脂秤有几种颜色|现在只推出了白色一款|体脂秤啥颜色啊|体脂秤颜色都有些什么|体脂秤颜色多吗|体脂秤有什么颜色可供选择|体脂秤颜色种类
体脂秤送电池吗|标配4节七号电池|体脂秤有配电池吗|体脂秤电池送不送啊|体脂秤电池你们有赠送吗|体脂秤电池免费吗|体脂秤电池一起配送吗
体脂秤怎么供电|需要装4节七号电池|体脂秤是充电吗|体脂秤是电池还是充电|体脂秤要几节电池|体脂秤要几号电池|体脂秤可以充电吗
体脂秤有多薄|比一枚五分钱硬币还薄哦|体脂秤厚不厚啊|体脂秤厚度多少|体脂秤薄不薄|体脂秤会不会很厚重|体脂秤薄吗
体脂秤显示屏是什么|是隐藏式LED显示屏哦|体脂秤显示屏是什么种类的|体脂秤屏幕是什么|体脂秤屏幕清晰吗|体脂秤显示屏好不好啊|体脂秤显示屏是隐藏式的吗
体脂秤滑不滑|体脂秤表面做了防滑纹理，是不会滑倒的哦|体脂秤容易摔跤吗|体脂秤滑吗|体脂秤防滑吗|体脂秤会不会很滑|体脂秤会让人滑倒吗
体脂秤还能测什么|一共能让您知道BMI、肌肉量等十项数据呢|除了体脂，体脂秤还能测什么|体脂秤只能测体脂吗|体脂秤还有什么功能|体脂秤能测肌肉量吗|体脂秤测哪些东西
体脂秤能测多少人|一共能测16人的数据|体脂秤人数有限制吗|体脂秤最多测多少人|体脂秤只能测一个人吗|体脂秤可以和别人一起测吗|体脂秤能存储几个人的数据
体脂秤怎么记录数据|与小米APP搭配，自动上传数据|体脂秤怎么显示数据|体脂秤数据怎么显示|体脂秤的结果在哪看|体脂秤的结果能直接看到吗|体脂秤的数据结果如何显示
体脂秤对手机有要求吗|支持Android4.4和iOS8.0及以上系统的手机|体脂秤对系统有要求吗|体脂秤安卓系统可以用吗|体脂秤苹果手机可以用吗|体脂秤对手机有什么要求|体脂秤系统有版本要求吗
体脂秤会变色吗|这您放心，体脂秤抗氧化能力很好的|体脂秤会不会变色啊|体脂秤变色了咋办|体脂秤不会变色吧|体脂秤永久了会变色吗|体脂秤颜色会不会老化
体脂秤会不会用久了就不准了|这您放心，体脂秤抗氧化能力很好的|体脂秤保质期有吗|体脂秤会不会失灵|体脂秤用多久会不准|体脂秤的准确度会不会下降|体脂秤会不会老化
体脂秤原理是什么|体脂秤是通过脚部接触电极来获得数据的|体脂秤怎么工作|体脂秤工作原理是啥|体脂秤有什么原理|体脂秤为什么能测体脂|体脂秤有什么道理
体脂秤会不会触电啊|这您放心，电流大小是远远低于安全大小的|体脂秤电流大吗|体脂秤有触电危险吗|体脂秤电流对人体有害吗|体脂秤会不会电流过高|体脂秤安全吗
体脂秤包邮吗|除顺丰外满150都是包邮的呢|体脂秤邮费多少|体脂秤寄过来要钱吗|体脂秤包不包邮啊|体脂秤邮费贵不贵|体脂秤要不要邮费
体脂秤可以用顺丰吗|顺丰邮费请咨询人工客服|体脂秤顺丰多少钱|体脂秤顺丰要加钱吗|体脂秤顺丰要加多少钱|体脂秤用顺丰快递可以吗|体脂秤能不能顺丰
体重秤测得准吗|测得很准的，欢迎来店里试用|体重秤准确度怎么样|体重秤准吗|体重秤准确率高吗|体重秤准不准啊|体重秤靠谱吗
体重秤是干嘛用的|是用来测量您的体重的哦|体重秤用途是什么|体重秤有什么用|体重秤用来做什么|体重秤用来干嘛|体重秤有什么功能
体重秤质量怎么样|那是相当Ok的|体重秤质量咋样|体重秤靠谱吗|体重秤的屏幕质量怎样|体重秤显示屏质量怎样|体重秤显示屏质量靠谱吗
体重秤有优惠吗|抱歉，目前没有优惠哦，请后续关注。|体重秤有优惠吗|体重秤现在有啥优惠没|体重秤能优惠吗|体重秤有优惠活动吗|体重秤现在有优惠活动吗
体重秤有承重限制吗|5kg-150kg都可以的|体重秤最大重量多少|体重秤多重会碎|体重秤最大承重多少|体重秤有最大重量吗|体重秤最大可以称多重
体重秤尺寸多少|体重秤是300*300*28.2mm|体重秤多大|体重秤长宽高多少|体重秤面积多大|体重秤占地方吗|体重秤会不会很大
体重秤有多重|体重秤是1.9kg|体重秤重量多少|体重秤多少千克|体重秤多少kg|体重秤重不重啊|体重秤质量多少
体重秤可以退吗|七天无理由退货哦|体重秤多久可以退|体重秤可以无理由退货吗|体重秤退货是什么样的|体重秤退货有什么规定吗|体重秤不喜欢可以退吗
体重秤保修期多久|保修期为一年，您可以放心使用|体重秤能保修多久|体重秤的保修期是多久|我想问下体重秤能保修多久|体重秤怎么保修呢|体重秤保修时间长吗
体重秤有几种颜色|现在只推出了白色一款|体重秤啥颜色啊|体重秤颜色都有些什么|体重秤颜色多吗|体重秤有什么颜色可供选择|体重秤颜色种类
体重秤送电池吗|标配4节五号电池|体重秤有配电池吗|体重秤电池送不送啊|体重秤电池你们有赠送吗|体重秤电池免费吗|体重秤电池一起配送吗
体重秤怎么供电|需要装4节五号电池|体重秤是充电吗|体重秤是电池还是充电|体重秤要几节电池|体重秤要几号电池|体重秤可以充电吗
体重秤有多薄|厚度大约为28mm|体重秤厚不厚啊|体重秤厚度多少|体重秤薄不薄|体重秤会不会很厚重|体重秤薄吗
体重秤显示屏是什么|是隐藏式LED显示屏哦|体重秤显示屏是什么种类的|体重秤屏幕是什么|体重秤屏幕清晰吗|体重秤显示屏好不好啊|体重秤显示屏是隐藏式的吗
体重秤滑不滑|体重秤表面做了防滑纹理，是不会滑倒的哦|体重秤容易摔跤吗|体重秤滑吗|体重秤防滑吗|体重秤会不会很滑|体重秤会让人滑倒吗
体重秤还能测什么|一共能让您知道BMI、肌肉量等十项数据呢|除了体脂，体重秤还能测什么|体重秤只能测体脂吗|体重秤还有什么功能|体重秤能测肌肉量吗|体重秤测哪些东西
体重秤能测多少人|您想测多少人都可以呢|体重秤人数有限制吗|体重秤最多测多少人|体重秤只能测一个人吗|体重秤可以和别人一起测吗|体重秤能存储几个人的数据
体重秤怎么记录数据|与小米APP搭配，自动上传数据|体重秤怎么显示数据|体重秤数据怎么显示|体重秤的结果在哪看|体重秤的结果能直接看到吗|体重秤的数据结果如何显示
体重秤对手机有要求吗|支持Android4.4和iOS8.0及以上系统的手机|体重秤对系统有要求吗|体重秤安卓系统可以用吗|体重秤苹果手机可以用吗|体重秤对手机有什么要求|体重秤系统有版本要求吗
体重秤精度高吗|您喝杯水都能测出来呢|体重秤精确度怎么样|体重秤最多有多精确|体重秤准吗|体重秤有多准|体重秤准确度高不高
体重秤会不会用久了就不准了|这您放心，体重秤抗氧化能力很好的|体重秤保质期有吗|体重秤会不会失灵|体重秤用多久会不准|体重秤的准确度会不会下降|体重秤会不会老化
体重秤原理是什么|体重秤是通过压力传感获得数据的|体重秤怎么工作|体重秤工作原理是啥|体重秤有什么原理|体重秤为什么能测体脂|体重秤有什么道理
体重秤可以换货吗|支持15天无理由换货哦|体重秤多久可以换货|体重秤换货有什么规定|体重秤换货是怎么操作|体重秤换货有时间限制吗|体重秤能无理由换货吗
体重秤包邮吗|需要15元运费|体重秤邮费多少|体重秤寄过来要钱吗|体重秤包不包邮啊|体重秤邮费贵不贵|体重秤要不要邮费
体重秤可以用顺丰吗|体重秤由小米进行上门配送|体重秤顺丰多少钱|体重秤顺丰要加钱吗|体重秤顺丰要加多少钱|体重秤用顺丰快递可以吗|体重秤能不能顺丰
智能插座会不会着火|智能插座有750摄氏度阻燃机制，请放心|智能插座万一着火怎么办|智能插座会不会导致火灾|智能插座有没有火灾隐患|智能插座万一短路着火怎么办|智能插座易燃吗
智能插座是干嘛用的|智能插座可以让您用手机远程控制电源开关|智能插座用途是什么|智能插座有什么用|智能插座用来做什么|智能插座用来干嘛|智能插座有什么功能
智能插座质量怎么样|那是相当Ok的|智能插座质量咋样|智能插座靠谱吗|智能插座质量怎么样|智能插座质量好吗|智能插座质量靠谱吗
智能插座有优惠吗|抱歉，目前没有优惠哦，请后续关注。|智能插座有优惠吗|智能插座现在有啥优惠没|智能插座能优惠吗|智能插座有优惠活动吗|智能插座现在有优惠活动吗
智能插座安全吗|我们是有3C安全认证的哦|智能插座有安全证书吗|智能插座安不安全|智能插座安全性怎么样|智能插座有没有安全隐患|智能插座有没有安全认证
智能插座尺寸多少|智能插座是55*44*31mm|智能插座多大|智能插座长宽高多少|智能插座面积多大|智能插座占地方吗|智能插座会不会很大
智能插座有多重|智能插座很轻的，重量完全可以忽略|智能插座重量多少|智能插座多少千克|智能插座多少kg|智能插座重不重啊|智能插座质量多少
智能插座可以退吗|七天无理由退货哦|智能插座多久可以退|智能插座可以无理由退货吗|智能插座退货是什么样的|智能插座退货有什么规定吗|智能插座不喜欢可以退吗
智能插座保修期多久|保修期为一年，您可以放心使用|智能插座能保修多久|智能插座的保修期是多久|我想问下智能插座能保修多久|智能插座怎么保修呢|智能插座保修时间长吗
智能插座有几种颜色|现在有白色和黑色两款|智能插座啥颜色啊|智能插座颜色都有些什么|智能插座颜色多吗|智能插座有什么颜色可供选择|智能插座颜色种类
智能插座使用有什么要求吗|只要有网络就能使用|智能插座使用需要什么条件|智能插座什么时候都能用吗|智能插座使用有什么限制吗|智能插座需要插电线吗|智能插座需要连线吗
智能插座怎么使用|只要与您的手机相连就能使用了哦|智能插座怎么操作|智能插座使用方法|智能插座如何使用|智能插座操作方式|智能插座怎么用
智能插座有几个版本|目前有基础版、ZigBee版和增强版|智能插座有哪些版本|智能插座有什么不同的版本|智能插座有不一样的版本吗|智能插座只有一种吗|智能插座共有多少版本
智能插座有触电危险吗|拥有独立安全门，有宠物和小孩都不用担心呢|智能插座会不会触电啊|智能插座会漏电吗|家里有小孩能用吗|家里有宠物能用吗|用手触摸会触电吗
智能插座能用大功率电器吗|大功率电器请放心使用|智能插座有功率限定吗|智能插座有没有最大功率|智能插座可以插大功率的东西吗|智能插座支持大功率电器吗|大功率电器也能用吗
智能插座有定时功能吗|可以在手机APP上进行定时设置|智能插座可以自动开闭吗|智能插座能定时吗|智能插座可以定时开关吗|智能插座可以设定时间吗|智能插座可以像闹钟一样定时吗
智能插座能隔很远控制吗|只要有网络就能使用|可以在很远的地方控制智能插座吗|智能插座有范围限制吗|智能插座控制范围有多大|智能插座范围太大会不会不管用|离得很远还管用吗
智能插座支持电水壶吗|一般家电都是支持的|智能插座支持电视机吗|智能插座支持电灯吗|智能插座支持电饭锅吗|智能插座支持空调吗|智能插座支持加湿器吗
智能插座对手机有要求吗|支持Android4.4和iOS8.0及以上系统的手机|智能插座支持加湿器吗|智能插座安卓系统可以用吗|智能插座苹果手机可以用吗|智能插座对手机有什么要求|智能插座系统有版本要求吗
智能插座几天能到呢|1-3天内即可到货，请耐心等待|什么时候能拿到货|多久可以寄到|最快啥时候可以寄到|最快多久收获|多久收获
智能插座会不会用久了就失灵|这您放心，智能插座抗氧化能力很好的|智能插座保质期有吗|智能插座会不会失灵|智能插座用多久会不准|智能插座的灵敏度会不会下降|智能插座会不会老化
智能插座原理是什么|智能插座是通过手机控制电源通断的|智能插座怎么工作|智能插座工作原理是啥|智能插座有什么原理|智能插座为什么能测体脂|智能插座有什么道理
智能插座可以换货吗|支持15天无理由换货哦|智能插座多久可以换货|智能插座换货有什么规定|智能插座换货是怎么操作|智能插座换货有时间限制吗|智能插座能无理由换货吗
智能插座包邮吗|除顺丰外都是包邮的呢|智能插座邮费多少|智能插座寄过来要钱吗|智能插座包不包邮啊|智能插座邮费贵不贵|智能插座要不要邮费
智能插座可以用顺丰吗|顺丰邮费请咨询人工客服|智能插座顺丰多少钱|智能插座顺丰要加钱吗|智能插座顺丰要加多少钱|智能插座用顺丰快递可以吗|智能插座能不能顺丰
手电筒会不会着火|安全性能您放心|手电筒万一着火怎么办|手电筒会不会导致火灾|手电筒有没有火灾隐患|手电筒万一短路着火怎么办|手电筒易燃吗
手电筒电池容量多大|3350mAh充电锂电池|手电筒是充电还是装电池|手电筒电池大不大|手电筒有多大电池容量|手电筒是什么电池|手电筒电池可以充电吗
手电筒质量怎么样|那是相当Ok的|手电筒质量咋样|手电筒靠谱吗|手电筒质量怎么样|手电筒质量好吗|手电筒质量靠谱吗
手电筒有优惠吗|抱歉，目前没有优惠哦，请后续关注。|手电筒有优惠吗|手电筒现在有啥优惠没|手电筒能优惠吗|手电筒有优惠活动吗|手电筒现在有优惠活动吗
手电筒安全吗|这您放心，请安心使用|手电筒有安全证书吗|手电筒安不安全|手电筒安全性怎么样|手电筒有没有安全隐患|手电筒有没有安全认证
手电筒尺寸多少|手电筒是120.2*25.5*25.5mm|手电筒多大|手电筒长宽高多少|手电筒面积多大|手电筒占地方吗|手电筒会不会很大
手电筒有多重|手电筒很轻的，重量完全可以忽略|手电筒重量多少|手电筒多少千克|手电筒多少kg|手电筒重不重啊|手电筒质量多少
手电筒可以退吗|七天无理由退货哦|手电筒多久可以退|手电筒可以无理由退货吗|手电筒退货是什么样的|手电筒退货有什么规定吗|手电筒不喜欢可以退吗
手电筒保修期多久|保修期为一年，您可以放心使用|手电筒能保修多久|手电筒的保修期是多久|我想问下手电筒能保修多久|手电筒怎么保修呢|手电筒保修时间长吗
手电筒有几种颜色|现在只有白色一款|手电筒啥颜色啊|手电筒颜色都有些什么|手电筒颜色多吗|手电筒有什么颜色可供选择|手电筒颜色种类
手电筒使用有什么要求吗|只要有电就能使用|手电筒使用需要什么条件|手电筒什么时候都能用吗|手电筒使用有什么限制吗|手电筒需要插电线吗|手电筒需要连线吗
手电筒怎么使用|只要旋转灯头就能使用了哦|手电筒怎么操作|手电筒使用方法|手电筒如何使用|手电筒操作方式|手电筒怎么用
手电筒有几档亮度呢|一共11档，满足您的不同需求|手电筒有几种亮度|手电筒亮度有几档|手电筒亮度有几种|手电筒只有一种亮度吗|手电筒亮度可以调节吗
手电筒有触电危险吗|这您放心，是非常安全的|手电筒会不会触电啊|手电筒会漏电吗|手电筒不会漏电吧|手电筒是绝缘的吗|用手触摸会触电吗
手电筒怎么调节亮度呢|通过旋转灯头调节|手电筒如何调节亮度|手电筒怎么改变亮度|手电筒如何改变亮度|手电筒怎么改变光的亮度|手电筒哪里可以调亮度
手电筒续航能力怎么样|充满电一共能用216分钟|手电筒一共能亮多久|手电筒亮的久吗|手电筒续航咋样|手电筒续航久不久|手电筒可以亮多长时间
手电筒最高亮度多少|最高亮度可达240lm|手电筒最亮有多亮|手电筒最强光有多亮|手电筒最大亮度有多少|手电筒亮吗|手电筒光强度怎么样
手电筒材料是什么|机身是铝合金的，坚固又美丽|手电筒什么做的|手电筒机身是金属的吗|手电筒机身是什么做的|手电筒坚固吗|手电筒耐摔吗
手电筒方便携带吗|非常方便携带的，小巧轻便|手电筒能随身带吗|手电筒可以放进口袋吗|手电筒携带便捷吗|手电筒随身带着方便吗|手电筒轻便吗
手电筒几天能到呢|1-3天内即可到货，请耐心等待|什么时候能拿到货|多久可以寄到|最快啥时候可以寄到|最快多久收获|多久收获
手电筒会不会用久了就失灵|这您放心，手电筒抗氧化能力很好的|手电筒保质期有吗|手电筒会不会失灵|手电筒用多久会不准|手电筒的准确度会不会下降|手电筒会不会老化
手电筒好用吗|这是小米的黑科技，用用就知道了|手电筒用起来咋样|手电筒用起来爽吗|手电筒好不好用啊|手电筒用起来怎么样|手电筒使用体验咋样
手电筒可以换货吗|支持15天无理由换货哦|手电筒多久可以换货|手电筒换货有什么规定|手电筒换货是怎么操作|手电筒换货有时间限制吗|手电筒能无理由换货吗
手电筒包邮吗|除顺丰外都是包邮的呢|手电筒邮费多少|手电筒寄过来要钱吗|手电筒包不包邮啊|手电筒邮费贵不贵|手电筒要不要邮费
手电筒可以用顺丰吗|顺丰邮费请咨询人工客服|手电筒顺丰多少钱|手电筒顺丰要加钱吗|手电筒顺丰要加多少钱|手电筒用顺丰快递可以吗|手电筒能不能顺丰
吸顶灯会不会着火|安全性能您放心|吸顶灯万一着火怎么办|吸顶灯会不会导致火灾|吸顶灯有没有火灾隐患|吸顶灯万一短路着火怎么办|吸顶灯易燃吗
吸顶灯电压多大|100-240V都可以|吸顶灯额定电压多少|吸顶灯工作电压范围|吸顶灯电压范围多少|吸顶灯需要多大电压|吸顶灯能在多大电压下工作
吸顶灯质量怎么样|那是相当Ok的|吸顶灯质量咋样|吸顶灯靠谱吗|吸顶灯质量怎么样|吸顶灯质量好吗|吸顶灯质量靠谱吗
吸顶灯有优惠吗|抱歉，目前没有优惠哦，请后续关注。|吸顶灯有优惠吗|吸顶灯现在有啥优惠没|吸顶灯能优惠吗|吸顶灯有优惠活动吗|吸顶灯现在有优惠活动吗
吸顶灯安全吗|这您放心，请安心使用|吸顶灯有安全证书吗|吸顶灯安不安全|吸顶灯安全性怎么样|吸顶灯有没有安全隐患|吸顶灯有没有安全认证
吸顶灯尺寸多少|直径499mm，厚度54mm|吸顶灯多大|吸顶灯长宽高多少|吸顶灯面积多大|吸顶灯占地方吗|吸顶灯会不会很大
吸顶灯有多重|吸顶灯大约1.63kg|吸顶灯重量多少|吸顶灯多少千克|吸顶灯多少kg|吸顶灯重不重啊|吸顶灯质量多少
吸顶灯可以退吗|七天无理由退货哦|吸顶灯多久可以退|吸顶灯可以无理由退货吗|吸顶灯退货是什么样的|吸顶灯退货有什么规定吗|吸顶灯不喜欢可以退吗
吸顶灯保修期多久|保修期为一年，您可以放心使用|吸顶灯能保修多久|吸顶灯的保修期是多久|我想问下吸顶灯能保修多久|吸顶灯怎么保修呢|吸顶灯保修时间长吗
吸顶灯有几种颜色|现在只有白色一款|吸顶灯啥颜色啊|吸顶灯颜色都有些什么|吸顶灯颜色多吗|吸顶灯有什么颜色可供选择|吸顶灯颜色种类
吸顶灯使用有什么要求吗|只要插电就能使用|吸顶灯使用需要什么条件|吸顶灯什么时候都能用吗|吸顶灯使用有什么限制吗|吸顶灯需要插电线吗|吸顶灯需要连线吗
吸顶灯怎么使用|只要与您的手机相连就能使用了哦|吸顶灯怎么操作|吸顶灯使用方法|吸顶灯如何使用|吸顶灯操作方式|吸顶灯怎么用
吸顶灯有几档亮度呢|可以调节不同的冷暖光呢|吸顶灯有几种亮度|吸顶灯亮度有几档|吸顶灯亮度有几种|吸顶灯只有一种亮度吗|吸顶灯亮度可以调节吗
吸顶灯有触电危险吗|这您放心，是非常安全的|吸顶灯会不会触电啊|吸顶灯会漏电吗|吸顶灯不会漏电吧|吸顶灯是绝缘的吗|用手触摸会触电吗
吸顶灯怎么调节亮度呢|通过手机APP调节|吸顶灯如何调节亮度|吸顶灯怎么改变亮度|吸顶灯如何改变亮度|吸顶灯怎么改变光的亮度|吸顶灯哪里可以调亮度
吸顶灯对手机有要求吗|支持Android4.4和iOS8.0及以上系统的手机|吸顶灯对手机系统有什么要求|吸顶灯安卓系统可以用吗|吸顶灯苹果手机可以用吗|吸顶灯对手机有什么要求|吸顶灯系统有版本要求吗
吸顶灯最高亮度多少|光通量可达3000lm|吸顶灯最亮有多亮|吸顶灯最强光有多亮|吸顶灯最大亮度有多少|吸顶灯亮吗|吸顶灯光强度怎么样
吸顶灯材料是什么|表面是塑料的，坚固又美丽|吸顶灯什么做的|吸顶灯灯罩是金属的吗|吸顶灯灯罩是什么做的|吸顶灯坚固吗|吸顶灯耐摔吗
吸顶灯额定电流多大呢|0.1A|吸顶灯工作时电流多大|吸顶灯工作电流大吗|吸顶灯额定电流大吗|吸顶灯电流大不大|吸顶灯工作电流大不大
吸顶灯几天能到呢|1-3天内即可到货，请耐心等待|什么时候能拿到货|多久可以寄到|最快啥时候可以寄到|最快多久收获|多久收获
吸顶灯会不会用久了就失灵|这您放心，吸顶灯抗氧化能力很好的|吸顶灯保质期有吗|吸顶灯会不会失灵|吸顶灯用多久会不准|吸顶灯的准确度会不会下降|吸顶灯会不会老化
吸顶灯好用吗|这是小米的黑科技，用用就知道了|吸顶灯用起来咋样|吸顶灯用起来爽吗|吸顶灯好不好用啊|吸顶灯用起来怎么样|吸顶灯使用体验咋样
吸顶灯可以换货吗|支持15天无理由换货哦|吸顶灯多久可以换货|吸顶灯换货有什么规定|吸顶灯换货是怎么操作|吸顶灯换货有时间限制吗|吸顶灯能无理由换货吗
吸顶灯包邮吗|除顺丰外都是包邮的呢|吸顶灯邮费多少|吸顶灯寄过来要钱吗|吸顶灯包不包邮啊|吸顶灯邮费贵不贵|吸顶灯要不要邮费
吸顶灯可以用顺丰吗|顺丰邮费请咨询人工客服|吸顶灯顺丰多少钱|吸顶灯顺丰要加钱吗|吸顶灯顺丰要加多少钱|吸顶灯用顺丰快递可以吗|吸顶灯能不能顺丰
智能灯泡会不会着火|安全性能您放心|智能灯泡万一着火怎么办|智能灯泡会不会导致火灾|智能灯泡有没有火灾隐患|智能灯泡万一短路着火怎么办|智能灯泡易燃吗
智能灯泡电压多大|220-240V都可以|智能灯泡额定电压多少|智能灯泡工作电压范围|智能灯泡电压范围多少|智能灯泡需要多大电压|智能灯泡能在多大电压下工作
智能灯泡质量怎么样|那是相当Ok的|智能灯泡质量咋样|智能灯泡靠谱吗|智能灯泡质量怎么样|智能灯泡质量好吗|智能灯泡质量靠谱吗
智能灯泡有优惠吗|抱歉，目前没有优惠哦，请后续关注。|智能灯泡有优惠吗|智能灯泡现在有啥优惠没|智能灯泡能优惠吗|智能灯泡有优惠活动吗|智能灯泡现在有优惠活动吗
智能灯泡安全吗|这您放心，请安心使用|智能灯泡有安全证书吗|智能灯泡安不安全|智能灯泡安全性怎么样|智能灯泡有没有安全隐患|智能灯泡有没有安全认证
智能灯泡尺寸多少|42*127mm|智能灯泡多大|智能灯泡长宽高多少|智能灯泡面积多大|智能灯泡占地方吗|智能灯泡会不会很大
智能灯泡有多重|水晶版65g，磨砂版60g|智能灯泡重量多少|智能灯泡多少千克|智能灯泡多少kg|智能灯泡重不重啊|智能灯泡质量多少
智能灯泡可以退吗|七天无理由退货哦|智能灯泡多久可以退|智能灯泡可以无理由退货吗|智能灯泡退货是什么样的|智能灯泡退货有什么规定吗|智能灯泡不喜欢可以退吗
智能灯泡保修期多久|保修期为一年，您可以放心使用|智能灯泡能保修多久|智能灯泡的保修期是多久|我想问下智能灯泡能保修多久|智能灯泡怎么保修呢|智能灯泡保修时间长吗
智能灯泡有几种颜色|现在有水晶版和磨山版供您选择|智能灯泡啥颜色啊|智能灯泡颜色都有些什么|智能灯泡颜色多吗|智能灯泡有什么颜色可供选择|智能灯泡颜色种类
智能灯泡使用有什么要求吗|只要插电就能使用|智能灯泡使用需要什么条件|智能灯泡什么时候都能用吗|智能灯泡使用有什么限制吗|智能灯泡需要插电线吗|智能灯泡需要连线吗
智能灯泡怎么使用|只要与您的手机相连就能使用了哦|智能灯泡怎么操作|智能灯泡使用方法|智能灯泡如何使用|智能灯泡操作方式|智能灯泡怎么用
智能灯泡有几档亮度呢|可以调节不同的冷暖光呢|智能灯泡有几种亮度|智能灯泡亮度有几档|智能灯泡亮度有几种|智能灯泡只有一种亮度吗|智能灯泡亮度可以调节吗
智能灯泡有触电危险吗|这您放心，是非常安全的|智能灯泡会不会触电啊|智能灯泡会漏电吗|智能灯泡不会漏电吧|智能灯泡是绝缘的吗|用手触摸会触电吗
智能灯泡怎么调节亮度呢|通过手机APP调节|智能灯泡如何调节亮度|智能灯泡怎么改变亮度|智能灯泡如何改变亮度|智能灯泡怎么改变光的亮度|智能灯泡哪里可以调亮度
智能灯泡对手机有要求吗|支持Android4.4和iOS8.0及以上系统的手机|智能灯泡支持加湿器吗|智能灯泡安卓系统可以用吗|智能灯泡苹果手机可以用吗|智能灯泡对手机有什么要求|智能灯泡系统有版本要求吗
智能灯泡最高亮度多少|水晶版250lm，磨砂版200lm|智能灯泡最亮有多亮|智能灯泡最强光有多亮|智能灯泡最大亮度有多少|智能灯泡亮吗|智能灯泡光强度怎么样
智能灯泡材料是什么|表面是塑料的，坚固又美丽|智能灯泡什么做的|智能灯泡灯罩是金属的吗|智能灯泡灯罩是什么做的|智能灯泡坚固吗|智能灯泡耐摔吗
智能灯泡额定电流多大呢|0.1A|智能灯泡工作时电流多大|智能灯泡工作电流大吗|智能灯泡额定电流大吗|智能灯泡电流大不大|智能灯泡工作电流大不大
智能灯泡几天能到呢|1-3天内即可到货，请耐心等待|什么时候能拿到货|多久可以寄到|最快啥时候可以寄到|最快多久收货|多久收货
智能灯泡会不会用久了就失灵|这您放心，智能灯泡抗氧化能力很好的|智能灯泡保质期有吗|智能灯泡会不会失灵|智能灯泡用多久会不准|智能灯泡的准确度会不会下降|智能灯泡会不会老化
智能灯泡好用吗|这是小米的黑科技，用用就知道了|智能灯泡用起来咋样|智能灯泡用起来爽吗|智能灯泡好不好用啊|智能灯泡用起来怎么样|智能灯泡使用体验咋样
智能灯泡可以换货吗|支持15天无理由换货哦|智能灯泡多久可以换货|智能灯泡换货有什么规定|智能灯泡换货是怎么操作|智能灯泡换货有时间限制吗|智能灯泡能无理由换货吗
智能灯泡包邮吗|除顺丰外满150都是包邮的呢|智能灯泡邮费多少|智能灯泡寄过来要钱吗|智能灯泡包不包邮啊|智能灯泡邮费贵不贵|智能灯泡要不要邮费
智能灯泡可以用顺丰吗|顺丰邮费请咨询人工客服|智能灯泡顺丰多少钱|智能灯泡顺丰要加钱吗|智能灯泡顺丰要加多少钱|智能灯泡用顺丰快递可以吗|智能灯泡能不能顺丰
智能摄像机1080P有夜视功能吗|10米红外夜视范围的呢|智能摄像机1080P晚上能工作吗|智能摄像机1080P夜视范围多少|智能摄像机1080P有红外功能吗|智能摄像机1080P夜晚可以工作吗|智能摄像机1080P夜晚有红外功能吗
智能摄像机1080P视野范围怎么样|有130度超广角镜头呢|智能摄像机1080P看得范围宽吗|智能摄像机1080P镜头是广角吗|智能摄像机1080P摄影范围咋样|智能摄像机1080P摄影范围大吗|智能摄像机1080P有多大角度摄影范围
智能摄像机1080P质量怎么样|那是相当Ok的|智能摄像机1080P质量咋样|智能摄像机1080P靠谱吗|智能摄像机1080P质量怎么样|智能摄像机1080P质量好吗|智能摄像机1080P质量靠谱吗
智能摄像机1080P有优惠吗|抱歉，目前没有优惠哦，请后续关注。|智能摄像机1080P有优惠吗|智能摄像机1080P现在有啥优惠没|智能摄像机1080P能优惠吗|智能摄像机1080P有优惠活动吗|智能摄像机1080P现在有优惠活动吗
智能摄像机1080P安全吗|这您放心，请安心使用|智能摄像机1080P有安全证书吗|智能摄像机1080P安不安全|智能摄像机1080P安全性怎么样|智能摄像机1080P有没有安全隐患|智能摄像机1080P有没有安全认证
智能摄像机1080P尺寸多少|114.3*80.2*80.2mm|智能摄像机1080P多大|智能摄像机1080P长宽高多少|智能摄像机1080P面积多大|智能摄像机1080P占地方吗|智能摄像机1080P会不会很大
智能摄像机1080P有多重|产品净重128g，毛重280g|智能摄像机1080P重量多少|智能摄像机1080P多少千克|智能摄像机1080P多少kg|智能摄像机1080P重不重啊|智能摄像机1080P质量多少
智能摄像机1080P可以退吗|七天无理由退货哦|智能摄像机1080P多久可以退|智能摄像机1080P可以无理由退货吗|智能摄像机1080P退货是什么样的|智能摄像机1080P退货有什么规定吗|智能摄像机1080P不喜欢可以退吗
智能摄像机1080P保修期多久|保修期为一年，您可以放心使用|智能摄像机1080P能保修多久|智能摄像机1080P的保修期是多久|我想问下智能摄像机1080P能保修多久|智能摄像机1080P怎么保修呢|智能摄像机1080P保修时间长吗
智能摄像机1080P有几种颜色|现在只有白色一款|智能摄像机1080P啥颜色啊|智能摄像机1080P颜色都有些什么|智能摄像机1080P颜色多吗|智能摄像机1080P有什么颜色可供选择|智能摄像机1080P颜色种类
智能摄像机1080P使用有什么要求吗|只要插电就能使用|智能摄像机1080P使用需要什么条件|智能摄像机1080P什么时候都能用吗|智能摄像机1080P使用有什么限制吗|智能摄像机1080P需要插电线吗|智能摄像机1080P需要连线吗
智能摄像机1080P怎么使用|只要与您的手机相连就能使用了哦|智能摄像机1080P怎么操作|智能摄像机1080P使用方法|智能摄像机1080P如何使用|智能摄像机1080P操作方式|智能摄像机1080P怎么用
智能摄像机1080P流畅吗|支持最大20fps的高帧率来保障画面的流畅度|智能摄像机1080P流畅度怎么样|智能摄像机1080P流不流畅|智能摄像机1080P画面卡吗|智能摄像机1080P画面卡不卡|智能摄像机1080P画面流畅度怎么样
智能摄像机1080P有触电危险吗|这您放心，是非常安全的|智能摄像机1080P会不会触电啊|智能摄像机1080P会漏电吗|智能摄像机1080P不会漏电吧|智能摄像机1080P是绝缘的吗|智能摄像机1080P用手触摸会触电吗
多个智能摄像机1080P能同时看到吗|支持手机一屏多画面|能同时看到多个画面吗|能用手机看到不同摄像机的画面吗|有很多摄像机怎么办|不同的摄像机的画面能同时看到吗|手机能同时监控多个摄像机吗
智能摄像机1080P对手机有要求吗|支持Android4.4和iOS8.0及以上系统的手机|智能摄像机1080P对手机系统有要求吗|智能摄像机1080P安卓系统可以用吗|智能摄像机1080P苹果手机可以用吗|智能摄像机1080P对手机有什么要求|智能摄像机1080P系统有版本要求吗
智能摄像机1080P支持语音吗|支持双向语音沟通|智能摄像机1080P能通话吗|智能摄像机1080P能语音沟通吗|智能摄像机1080P有麦克风吗|智能摄像机1080P能记录声音吗|智能摄像机1080P能传输声音吗
智能摄像机1080P能报警吗|采取分级报警机制，减少无效报警|智能摄像机1080P报警怎么样|智能摄像机1080P会自动报警吗|智能摄像机1080P会报警吗|智能摄像机1080P有自动报警功能吗|智能摄像机1080P能发出警报吗
智能摄像机1080P能随时关掉吗|家人回家后可设置智能睡眠，保护隐私|智能摄像机1080P会破坏隐私吗|智能摄像机1080P怎么保护隐私|智能摄像机1080P会自动睡眠吗|智能摄像机1080P有自动睡眠功能吗|智能摄像机1080P能识别家人吗
智能摄像机1080P几天能到呢|1-3天内即可到货，请耐心等待|什么时候能拿到货|多久可以寄到|最快啥时候可以寄到|最快多久收货|多久收货
智能摄像机1080P会不会用久了就失灵|这您放心，智能摄像机1080P抗氧化能力很好的|智能摄像机1080P保质期有吗|智能摄像机1080P会不会失灵|智能摄像机1080P用多久会不准|智能摄像机1080P的准确度会不会下降|智能摄像机1080P会不会老化
智能摄像机1080P好用吗|这是小米的黑科技，用用就知道了|智能摄像机1080P用起来咋样|智能摄像机1080P用起来爽吗|智能摄像机1080P好不好用啊|智能摄像机1080P用起来怎么样|智能摄像机1080P使用体验咋样
智能摄像机1080P可以换货吗|支持15天无理由换货哦|智能摄像机1080P多久可以换货|智能摄像机1080P换货有什么规定|智能摄像机1080P换货是怎么操作|智能摄像机1080P换货有时间限制吗|智能摄像机1080P能无理由换货吗
智能摄像机1080P包邮吗|除顺丰外满150都是包邮的呢|智能摄像机1080P邮费多少|智能摄像机1080P寄过来要钱吗|智能摄像机1080P包不包邮啊|智能摄像机1080P邮费贵不贵|智能摄像机1080P要不要邮费
智能摄像机1080P可以用顺丰吗|顺丰邮费请咨询人工客服|智能摄像机1080P顺丰多少钱|智能摄像机1080P顺丰要加钱吗|智能摄像机1080P顺丰要加多少钱|智能摄像机1080P用顺丰快递可以吗|智能摄像机1080P能不能顺丰
智能摄像机大众版有夜视功能吗|具有9m红外夜视功能的呢|智能摄像机大众版晚上能工作吗|智能摄像机大众版夜视范围多少|智能摄像机大众版有红外功能吗|智能摄像机大众版夜晚可以工作吗|智能摄像机大众版夜晚有红外功能吗
智能摄像机大众版视野范围怎么样|有100.4度广角镜头呢|智能摄像机大众版看得范围宽吗|智能摄像机大众版镜头是广角吗|智能摄像机大众版摄影范围咋样|智能摄像机大众版摄影范围大吗|智能摄像机大众版有多大角度摄影范围
智能摄像机大众版质量怎么样|那是相当Ok的|智能摄像机大众版质量咋样|智能摄像机大众版靠谱吗|智能摄像机大众版质量怎么样|智能摄像机大众版质量好吗|智能摄像机大众版质量靠谱吗
智能摄像机大众版有优惠吗|抱歉，目前没有优惠哦，请后续关注。|智能摄像机大众版有优惠吗|智能摄像机大众版现在有啥优惠没|智能摄像机大众版能优惠吗|智能摄像机大众版有优惠活动吗|智能摄像机大众版现在有优惠活动吗
智能摄像机大众版安全吗|这您放心，请安心使用|智能摄像机大众版有安全证书吗|智能摄像机大众版安不安全|智能摄像机大众版安全性怎么样|智能摄像机大众版有没有安全隐患|智能摄像机大众版有没有安全认证
智能摄像机大众版分辨率多少|720p高清|智能摄像机大众版清晰吗|智能摄像机大众版清晰度多少|智能摄像机大众版分辨率多大|智能摄像机大众版画面清楚吗|智能摄像机大众版画面清晰度咋样
智能摄像机大众版有多重|65g|智能摄像机大众版重量多少|智能摄像机大众版多少千克|智能摄像机大众版多少kg|智能摄像机大众版重不重啊|智能摄像机大众版质量多少
智能摄像机大众版可以退吗|七天无理由退货哦|智能摄像机大众版多久可以退|智能摄像机大众版可以无理由退货吗|智能摄像机大众版退货是什么样的|智能摄像机大众版退货有什么规定吗|智能摄像机大众版不喜欢可以退吗
智能摄像机大众版保修期多久|保修期为一年，您可以放心使用|智能摄像机大众版能保修多久|智能摄像机大众版的保修期是多久|我想问下智能摄像机大众版能保修多久|智能摄像机大众版怎么保修呢|智能摄像机大众版保修时间长吗
智能摄像机大众版有几种颜色|现在只有白色一款|智能摄像机大众版啥颜色啊|智能摄像机大众版颜色都有些什么|智能摄像机大众版颜色多吗|智能摄像机大众版有什么颜色可供选择|智能摄像机大众版颜色种类
智能摄像机大众版使用有什么要求吗|只要插电就能使用|智能摄像机大众版使用需要什么条件|智能摄像机大众版什么时候都能用吗|智能摄像机大众版使用有什么限制吗|智能摄像机大众版需要插电线吗|智能摄像机大众版需要连线吗
智能摄像机大众版怎么使用|只要与您的手机相连就能使用了哦|智能摄像机大众版怎么操作|智能摄像机大众版使用方法|智能摄像机大众版如何使用|智能摄像机大众版操作方式|智能摄像机大众版怎么用
智能摄像机大众版流畅吗|很流畅的，请您放心|智能摄像机大众版流畅度怎么样|智能摄像机大众版流不流畅|智能摄像机大众版画面卡吗|智能摄像机大众版画面卡不卡|智能摄像机大众版画面流畅度怎么样
智能摄像机大众版有触电危险吗|这您放心，是非常安全的|智能摄像机大众版会不会触电啊|智能摄像机大众版会漏电吗|智能摄像机大众版不会漏电吧|智能摄像机大众版是绝缘的吗|智能摄像机大众版用手触摸会触电吗
多个智能摄像机大众版能同时看到吗|支持手机一屏多画面|能同时看到多个画面吗|能用手机看到不同摄像机的画面吗|有很多摄像机怎么办|不同的摄像机的画面能同时看到吗|手机能同时监控多个摄像机吗
智能摄像机大众版对手机有要求吗|支持Android4.4和iOS8.0及以上系统的手机|智能摄像机大众版对手机系统有要求吗|智能摄像机大众版安卓系统可以用吗|智能摄像机大众版苹果手机可以用吗|智能摄像机大众版对手机有什么要求|智能摄像机大众版系统有版本要求吗
智能摄像机大众版支持语音吗|支持双向语音沟通|智能摄像机大众版能通话吗|智能摄像机大众版能语音沟通吗|智能摄像机大众版有麦克风吗|智能摄像机大众版能记录声音吗|智能摄像机大众版能传输声音吗
智能摄像机大众版能报警吗|可以侦测画面动态并将警告通知发至手机|智能摄像机大众版报警怎么样|智能摄像机大众版会自动报警吗|智能摄像机大众版会报警吗|智能摄像机大众版有自动报警功能吗|智能摄像机大众版能发出警报吗
智能摄像机大众版能随时关掉吗|可设置休眠时间，保护隐私|智能摄像机大众版会破坏隐私吗|智能摄像机大众版怎么保护隐私|智能摄像机大众版会自动睡眠吗|智能摄像机大众版有自动睡眠功能吗|智能摄像机大众版能识别家人吗
智能摄像机大众版几天能到呢|1-3天内即可到货，请耐心等待|什么时候能拿到货|多久可以寄到|最快啥时候可以寄到|最快多久收货|多久收货
智能摄像机大众版会不会用久了就失灵|这您放心，智能摄像机大众版抗氧化能力很好的|智能摄像机大众版保质期有吗|智能摄像机大众版会不会失灵|智能摄像机大众版用多久会不准|智能摄像机大众版的准确度会不会下降|智能摄像机大众版会不会老化
智能摄像机大众版好用吗|这是小米的黑科技，用用就知道了|智能摄像机大众版用起来咋样|智能摄像机大众版用起来爽吗|智能摄像机大众版好不好用啊|智能摄像机大众版用起来怎么样|智能摄像机大众版使用体验咋样
智能摄像机大众版可以换货吗|支持15天无理由换货哦|智能摄像机大众版多久可以换货|智能摄像机大众版换货有什么规定|智能摄像机大众版换货是怎么操作|智能摄像机大众版换货有时间限制吗|智能摄像机大众版能无理由换货吗
智能摄像机大众版包邮吗|除顺丰外满150都是包邮的呢|智能摄像机大众版邮费多少|智能摄像机大众版寄过来要钱吗|智能摄像机大众版包不包邮啊|智能摄像机大众版邮费贵不贵|智能摄像机大众版要不要邮费
智能摄像机大众版可以用顺丰吗|顺丰邮费请咨询人工客服|智能摄像机大众版顺丰多少钱|智能摄像机大众版顺丰要加钱吗|智能摄像机大众版顺丰要加多少钱|智能摄像机大众版用顺丰快递可以吗|智能摄像机大众版能不能顺丰
